id,kandidat,valg,parti,rangering,rangering_original,valgt,personstemmer,slengere,partistemmer,partiprosent,parti_original,count,election,total_hits,decay,hits_after_list_public,cum_hits,hits_before_list_public
kandidat000000,Aage Johan Sundvor,2007,dem,21,15,Ikke valgt,2,1,306000,0.11,Demokratene,3,NA,0,0,0,0,0
kandidat000001,Aamir J. Sheikh,2007,h,19,50,Vara,621,128,68475,25.19,Høyre,749,2007-09-10,97,2.10763902262162,3,181,178
kandidat000002,Abdullah Alsabeehg,2011,ap,3,6,Valgt,3918,123,102707,33.1,Det norske Arbeiderparti,4041,2011-09-12,172,10.2128905868048,18,175,157
kandidat000003,Abdullah Alsabeehg,2015,ap,15,13,Valgt,3656,140,102431,31.97,Arbeiderpartiet,3796,2015-09-14,758,44.5919971594047,66,933,867
kandidat000004,Abel Ole Østerberg,2011,krf,54,55,Ikke valgt,21,2,7571,2.44,Kristelig Folkeparti,23,NA,0,0,0,0,0
kandidat000005,Abel Østerberg,2015,krf,53,55,Ikke valgt,24,2,7827,2.44,Kristelig Folkeparti,26,NA,0,0,0,0,0
kandidat000006,Ada Molne Kjøllesdal,2011,frp,34,23,Ikke valgt,102,7,21852,7.04,Fremskrittspartiet,109,2011-09-12,53,4.57719311066468,0,55,55
kandidat000007,Adam Reiremo,2015,sv,49,38,Ikke valgt,97,11,17445,5.44,Sosialistisk Venstreparti,108,2015-09-14,33,0.183047112488241,1,91,90
kandidat000008,Adam Tumidajewicz,2015,mdg,32,12,Ikke valgt,206,22,26096,8.14,Miljøpartiet De Grønne,228,2015-09-14,13,1.24851838342799,2,87,85
kandidat000009,Adrian Larsen Steinbø,2015,nkp,6,3,Ikke valgt,16,7,240,0.07,Norges Kommunistiske Parti,23,NA,0,0,0,0,0
kandidat000010,Aga Sadlowska,2011,h,59,47,Ikke valgt,247,5,110776,35.7,Høyre,252,2011-09-12,21,0.851952078202158,2,21,19
kandidat000011,Aga Sadlowska,2015,h,49,34,Ikke valgt,390,22,101882,31.8,Høyre,412,2015-09-14,13,0.564988372691471,1,34,33
kandidat000012,Åge Breimo,2007,sfp,18,17,Ikke valgt,3,1,129000,0.05,Samfunnspartiet,4,2007-09-10,3,1.54436134759095e-13,0,3,3
kandidat000013,Agnar Bjarne Thesen,2007,kp,40,39,Ikke valgt,1,0,120000,0.04,Kystpartiet,1,NA,0,0,0,0,0
kandidat000014,Agnar Blom,2007,dem,11,11,Ikke valgt,5,3,306000,0.11,Demokratene,8,2007-09-10,17,0.0502937065411178,0,21,21
kandidat000015,Agnes Arnadottir,2015,v,14,17,Ikke valgt,311,38,21986,6.86,Venstre,349,2015-09-14,98,0.7693633909093,1,99,98
kandidat000016,Agnes Nærland Viljugrein,2015,ap,50,48,Ikke valgt,656,92,102431,31.97,Arbeiderpartiet,748,2015-09-14,61,2.98230897858896,3,62,59
kandidat000017,Ahmed Ali Wais,2007,ap,13,15,Valgt,1646,81,81265,29.89,Det norske Arbeiderparti,1727,2007-09-10,24,0.913540246815424,1,26,25
kandidat000018,Aina Nesmoen,2011,mdg,25,34,Ikke valgt,51,4,7653,2.47,Miljøpartiet De Grønne,55,2011-09-12,1,0.000567085767638304,0,3,3
kandidat000019,Aina Stenersen,2011,frp,6,8,Vara,443,36,21852,7.04,Fremskrittspartiet,479,2011-09-12,245,27.0426887611029,43,250,207
kandidat000020,Aina Stenersen,2015,frp,5,7,Vara,481,42,19311,6.03,Fremskrittspartiet,523,2015-09-14,896,32.9723246921861,52,1146,1094
kandidat000021,Aisha Naz Bhatti,2015,sp,1,1,Ikke valgt,358,325,1926,0.6,Senterpartiet,683,2015-09-14,153,56.7115795427101,101,153,52
kandidat000022,Akhtar Chaudhry,2007,sv,1,3,Valgt,3600,412,28701,10.56,Sosialistisk Venstreparti,4012,2007-09-10,1369,55.8474269533203,107,1593,1486
kandidat000023,Aksel Eide-Fredriksen,2007,mdg,56,45,Ikke valgt,5,0,1687,0.62,Miljøpartiet De Grønne,5,NA,0,0,0,0,0
kandidat000024,Aksel Fridstrøm,2011,h,39,25,Vara,497,18,110776,35.7,Høyre,515,2011-09-12,29,1.63660351283625,2,37,35
kandidat000025,Aksel Fridstrøm,2015,h,28,18,Vara,704,25,101882,31.8,Høyre,729,2015-09-14,16,0.976736471766255,1,53,52
kandidat000026,Aksel Jakobsen,2007,krf,52,40,Ikke valgt,25,0,8368,3.08,Kristelig Folkeparti,25,2007-09-10,141,0.884043291264363,2,155,153
kandidat000027,Aksel Torsnes Mehlum,2007,sp,8,23,Ikke valgt,31,32,2189,0.81,Senterpartiet,63,2007-09-10,8,0.932912783220473,3,9,6
kandidat000028,Aksel Torsnes Mehlum,2011,sp,8,12,Ikke valgt,23,33,1591,0.51,Senterpartiet,56,2011-09-12,10,1.19595642743162,2,19,17
kandidat000029,Aksel Torsnes Mehlum,2015,sp,12,50,Ikke valgt,27,21,1926,0.6,Senterpartiet,48,2015-09-14,11,4.65828933627623,6,30,24
kandidat000030,Aled Dilwyn Fisher,2015,rv,61,45,Ikke valgt,57,6,16174,5.05,Rødt,63,2015-09-14,13,1.1198656098111,1,13,12
kandidat000031,Aleksandra Witczak Haugstad,2015,h,42,54,Ikke valgt,459,12,101882,31.8,Høyre,471,2015-09-14,13,0.013930494781103,0,20,20
kandidat000032,Alette Elvenes,2007,mdg,3,4,Ikke valgt,100,79,1687,0.62,Miljøpartiet De Grønne,179,NA,0,0,0,0,0
kandidat000033,Alette Elvenes,2011,mdg,22,24,Ikke valgt,59,6,7653,2.47,Miljøpartiet De Grønne,65,2011-09-12,6,1.60575643782667,2,6,4
kandidat000034,Alexa Døving,2007,osby,43,50,Ikke valgt,8,4,1466,0.54,Oslo Byaksjon,12,2007-09-10,93,0.414038118685204,0,104,104
kandidat000035,Alexander Calapini-Solberg,2007,kp,13,12,Ikke valgt,3,0,120000,0.04,Kystpartiet,3,NA,0,0,0,0,0
kandidat000036,Alexander Melli,2015,mdg,60,52,Ikke valgt,93,11,26096,8.14,Miljøpartiet De Grønne,104,2015-09-14,4,1.14705796652256e-07,0,39,39
kandidat000037,Alexander Thomas Melli,2011,mdg,52,57,Ikke valgt,29,1,7653,2.47,Miljøpartiet De Grønne,30,NA,0,0,0,0,0
kandidat000038,Alice Aarebrodt,2015,h,45,56,Ikke valgt,432,12,101882,31.8,Høyre,444,2015-09-14,9,1.72904548983681,4,10,6
kandidat000039,Alice Reite,2007,mdg,42,40,Ikke valgt,5,3,1687,0.62,Miljøpartiet De Grønne,8,2007-09-10,3,2.7382063159905e-07,0,24,24
kandidat000040,Alice Reite,2011,mdg,29,16,Ikke valgt,38,12,7653,2.47,Miljøpartiet De Grønne,50,2011-09-12,1,2.51645440824311e-10,0,25,25
kandidat000041,Ali Mirahmadi,2015,rv,51,36,Ikke valgt,92,9,16174,5.05,Rødt,101,2015-09-14,9,1.84560756399207,2,10,8
kandidat000042,Alvhild Hedstein,2007,v,45,38,Ikke valgt,133,13,23703,8.72,Venstre,146,2007-09-10,406,24.4618784139284,72,513,441
kandidat000043,Alvhild Hedstein,2011,v,35,36,Ikke valgt,126,7,25351,8.17,Venstre,133,2011-09-12,801,8.26652566628413,15,1314,1299
kandidat000044,Amanda Steggell,2007,osby,52,55,Ikke valgt,9,0,1466,0.54,Oslo Byaksjon,9,2007-09-10,25,0.266198475652355,1,45,44
kandidat000045,Amin Senatorzade,2015,rv,58,49,Ikke valgt,69,4,16174,5.05,Rødt,73,2015-09-14,16,0.07545361729117,0,18,18
kandidat000046,Amir Torkamanipour,2011,rv,35,30,Ikke valgt,80,8,11257,3.63,Rødt,88,2011-09-12,6,1.23727767217857e-06,0,6,6
kandidat000047,Anders Cameroon Dale,2007,mdg,39,51,Ikke valgt,4,6,1687,0.62,Miljøpartiet De Grønne,10,NA,0,0,0,0,0
kandidat000048,Anders Døvre,2011,dem,6,5,Ikke valgt,5,3,214000,0.07,Demokratene i Norge,8,2011-09-12,3,3.64500256842763e-05,0,3,3
kandidat000049,Anders Gaasland,2007,v,43,36,Ikke valgt,137,20,23703,8.72,Venstre,157,2007-09-10,5,0.182318704816304,1,19,18
kandidat000050,Anders Greif Mathisen,2007,ap,37,27,Vara,581,21,81265,29.89,Det norske Arbeiderparti,602,2007-09-10,5,0.981867265200236,3,166,163
kandidat000051,Anders Imenes,2011,mdg,21,19,Ikke valgt,52,13,7653,2.47,Miljøpartiet De Grønne,65,2011-09-12,18,1.04735795792256,2,55,53
kandidat000052,Anders Mathisen Bergsaker,2011,v,10,7,Vara,383,23,25351,8.17,Venstre,406,NA,0,0,0,0,0
kandidat000053,Anders Røberg-Larsen,2011,ap,6,8,Valgt,2486,60,102707,33.1,Det norske Arbeiderparti,2546,2011-09-12,487,19.0861412375865,38,541,503
kandidat000054,Anders Røberg-Larsen,2015,ap,4,5,Valgt,3035,96,102431,31.97,Arbeiderpartiet,3131,2015-09-14,598,23.3638849357643,37,1139,1102
kandidat000055,Anders Skyrud Danielsen,2015,mdg,53,32,Ikke valgt,122,8,26096,8.14,Miljøpartiet De Grønne,130,2015-09-14,60,3.27797636599665,5,63,58
kandidat000056,Anders Wiggo Borglund,2011,pp,12,24,Ikke valgt,16,0,1045,0.34,Pensjonistpartiet,16,NA,0,0,0,0,0
kandidat000057,Andreas Behring,2007,sv,9,7,Vara,676,83,28701,10.56,Sosialistisk Venstreparti,759,2007-09-10,328,37.3831045475137,86,333,247
kandidat000058,Andreas Behring,2011,sv,5,2,Vara,884,234,19477,6.28,Sosialistisk Venstreparti,1118,2011-09-12,622,79.4773741108026,157,955,798
kandidat000059,Andreas Borud,2015,sv,9,10,Vara,486,166,17445,5.44,Sosialistisk Venstreparti,652,2015-09-14,261,1.00745550535793,1,445,444
kandidat000060,Andreas Delsett,2011,rv,28,20,Ikke valgt,96,18,11257,3.63,Rødt,114,2011-09-12,103,0.193696598611019,0,113,113
kandidat000061,Andreas Halse,2007,ap,17,11,Valgt,1279,64,81265,29.89,Det norske Arbeiderparti,1343,2007-09-10,29,1.35104339082652,3,65,62
kandidat000062,Andreas Halse,2011,ap,8,4,Valgt,2237,94,102707,33.1,Det norske Arbeiderparti,2331,2011-09-12,366,12.8608334262101,20,431,411
kandidat000063,Andreas Halse,2015,ap,9,7,Valgt,2045,99,102431,31.97,Arbeiderpartiet,2144,2015-09-14,2805,46.2535649911304,74,3236,3162
kandidat000064,Andreas Haug Løland,2011,krf,43,42,Ikke valgt,49,0,7571,2.44,Kristelig Folkeparti,49,2011-09-12,11,0.656271836253587,1,12,11
kandidat000065,Andreas Magnus,2011,krf,18,45,Ikke valgt,131,3,7571,2.44,Kristelig Folkeparti,134,2011-09-12,33,1.46068343882528,3,432,429
kandidat000066,Andreas Olsen,2015,ap,39,45,Vara,1077,60,102431,31.97,Arbeiderpartiet,1137,2015-09-14,900,31.1694014152386,95,2229,2134
kandidat000067,Andreas Skjæret,2015,v,33,51,Ikke valgt,141,13,21986,6.86,Venstre,154,2015-09-14,135,1.70612754373245,2,146,144
kandidat000068,Andreas Strandskog,2011,h,45,54,Vara,436,8,110776,35.7,Høyre,444,2011-09-12,11,3.20150801650143,7,11,4
kandidat000069,Andreas Svoor,2015,frp,15,14,Ikke valgt,206,18,19311,6.03,Fremskrittspartiet,224,2015-09-14,16,0.0225058054067777,0,21,21
kandidat000070,Andreas Tinglum,2007,sv,50,36,Ikke valgt,118,3,28701,10.56,Sosialistisk Venstreparti,121,2007-09-10,8,8.98298103714319e-06,0,12,12
kandidat000071,Andreas Tinglum,2011,sv,49,42,Ikke valgt,83,5,19477,6.28,Sosialistisk Venstreparti,88,2011-09-12,11,3.11476510980173e-05,0,23,23
kandidat000072,Andreas Vaa Bermann,2007,osby,24,12,Ikke valgt,14,11,1466,0.54,Oslo Byaksjon,25,2007-09-10,15,0.0335507311468398,0,18,18
kandidat000073,Andrea Tveeikrem Strømskag,2015,sv,33,31,Ikke valgt,197,8,17445,5.44,Sosialistisk Venstreparti,205,2015-09-14,2,1.08338954376751e-08,0,4,4
kandidat000074,Andrè Gausen,2011,kp,16,9,Ikke valgt,2,0,126000,0.04,Kystpartiet,2,2011-09-12,1,8.58147842208601e-13,0,2,2
kandidat000075,Andrè Gausen,2015,kp,4,6,Ikke valgt,12,2,124,0.04,Kystpartiet,14,2015-09-14,1,1.44522618242707e-09,0,3,3
kandidat000076,Andrew Kroglund,2015,mdg,33,24,Ikke valgt,197,24,26096,8.14,Miljøpartiet De Grønne,221,2015-09-14,323,10.9614375556535,22,581,559
kandidat000077,Ane Hansdatter Kismul,2011,sp,3,3,Ikke valgt,84,51,1591,0.51,Senterpartiet,135,2011-09-12,243,3.04850419213597,5,2424,2419
kandidat000078,Ane Hansdatter Kismul,2015,sp,35,51,Ikke valgt,15,2,1926,0.6,Senterpartiet,17,2015-09-14,619,0.312302823908577,1,3043,3042
kandidat000079,Ane Margrete Wigers,2015,v,57,63,Ikke valgt,84,3,21986,6.86,Venstre,87,2015-09-14,2,6.05866633430367e-15,0,10,10
kandidat000080,Anett Andreassen,2007,da,4,4,Ikke valgt,16,7,191000,0.07,Demokratisk Alternativ for Oslo,23,2007-09-10,3,0.000145099982518268,0,3,3
kandidat000081,Anette Hjertø,2007,h,41,33,Ikke valgt,324,9,68475,25.19,Høyre,333,NA,0,0,0,0,0
kandidat000082,Anette Wiig Bryn,2007,frp,4,5,Valgt,1005,79,38873,14.3,Fremskrittspartiet,1084,2007-09-10,1622,136.9445948663,169,1634,1465
kandidat000083,Ane Willumsen,2007,v,6,6,Vara,1020,165,23703,8.72,Venstre,1185,2007-09-10,274,0.691711748539682,1,378,377
kandidat000084,Anfinn Bernaas,2007,sp,48,40,Ikke valgt,6,1,2189,0.81,Senterpartiet,7,2007-09-10,9,0.954898075759619,1,16,15
kandidat000085,Angelika Liepelt,2007,ksp,8,6,Ikke valgt,5,2,158000,0.06,Kristent Samlingsparti,7,NA,0,0,0,0,0
kandidat000086,Anita Lie,2015,rv,44,44,Ikke valgt,107,8,16174,5.05,Rødt,115,2015-09-14,61,0.840325688451482,5,133,128
kandidat000087,Anita Ma,2011,krf,41,44,Ikke valgt,47,4,7571,2.44,Kristelig Folkeparti,51,2011-09-12,1,1.24631513025666e-14,0,1,1
kandidat000088,Anita Ma,2015,krf,48,35,Ikke valgt,29,0,7827,2.44,Kristelig Folkeparti,29,NA,0,0,0,0,0
kandidat000089,Anita Sundal Skjøstad,2015,h,55,46,Ikke valgt,331,2,101882,31.8,Høyre,333,2015-09-14,22,3.11938957556545,6,36,30
kandidat000090,Anita Wold,2015,v,43,64,Ikke valgt,106,17,21986,6.86,Venstre,123,2015-09-14,44,1.58358553866556,4,154,150
kandidat000091,Anja Askeland,2011,mdg,43,36,Ikke valgt,34,5,7653,2.47,Miljøpartiet De Grønne,39,2011-09-12,10,0.1625134144248,1,14,13
kandidat000092,Anka Ødegaardshaugen,2011,rv,57,58,Ikke valgt,36,2,11257,3.63,Rødt,38,2011-09-12,62,0.645971774766333,1,75,74
kandidat000093,Anna Blix,2007,rv,24,26,Ikke valgt,135,13,14131,5.2,Rød Valgallianse,148,2007-09-10,14,0.0281698306523959,0,21,21
kandidat000094,Anna-Karin Hopen,2007,kp,6,3,Ikke valgt,7,1,120000,0.04,Kystpartiet,8,NA,0,0,0,0,0
kandidat000095,Anna Olavsdatter Buverud,2007,v,38,29,Ikke valgt,177,5,23703,8.72,Venstre,182,2007-09-10,1,0.91210514954509,1,1,0
kandidat000096,Anna Olavsdotter Kolberg Buverud,2011,v,31,29,Ikke valgt,143,14,25351,8.17,Venstre,157,2011-09-12,2,1.55293576364748,2,2,0
kandidat000097,Anna Regina Jenssen,2015,sp,22,24,Ikke valgt,25,2,1926,0.6,Senterpartiet,27,NA,0,0,0,0,0
kandidat000098,Anna-Sabina Soggiu,2011,sv,20,33,Ikke valgt,208,39,19477,6.28,Sosialistisk Venstreparti,247,2011-09-12,29,7.19580508752581,12,29,17
kandidat000099,Ann Bente Bergersen,2011,dem,13,8,Ikke valgt,5,1,214000,0.07,Demokratene i Norge,6,2011-09-12,1,1.05823900325618e-13,0,2,2
kandidat000100,Anne Beate Hovind,2007,osby,8,7,Ikke valgt,49,18,1466,0.54,Oslo Byaksjon,67,2007-09-10,29,0.924933312377524,1,67,66
kandidat000101,Anne Bjerke,2007,v,29,25,Ikke valgt,201,11,23703,8.72,Venstre,212,2007-09-10,17,1.10121853002845,3,31,28
kandidat000102,Anne Bjerke,2015,v,23,23,Ikke valgt,171,24,21986,6.86,Venstre,195,2015-09-14,73,2.67321937352752,6,160,154
kandidat000103,Anne Brinch Skaara,2007,mdg,29,20,Ikke valgt,15,2,1687,0.62,Miljøpartiet De Grønne,17,2007-09-10,9,0.3898299296624,2,21,19
kandidat000104,Anne Brinch Skaara,2011,mdg,28,32,Ikke valgt,46,5,7653,2.47,Miljøpartiet De Grønne,51,2011-09-12,13,0.00518348342873783,0,34,34
kandidat000105,Anne-Britt Gran,2007,osby,7,10,Ikke valgt,46,28,1466,0.54,Oslo Byaksjon,74,2007-09-10,93,1.77355577288387,6,163,157
kandidat000106,Anne-Catherin Gonzales,2011,nkp,2,2,Ikke valgt,21,8,210000,0.07,Norges Kommunistiske Parti,29,2011-09-12,2,0.589193873612947,1,2,1
kandidat000107,Anne-Catherin Gonzales,2015,nkp,3,4,Ikke valgt,23,7,240,0.07,Norges Kommunistiske Parti,30,2015-09-14,6,1.8507411163978e-14,0,8,8
kandidat000108,Anne Cathrine Berger,2007,ap,27,32,Vara,839,22,81265,29.89,Det norske Arbeiderparti,861,2007-09-10,40,3.57257499037978,7,52,45
kandidat000109,Anne Cathrine Berger,2011,ap,21,15,Vara,1311,49,102707,33.1,Det norske Arbeiderparti,1360,2011-09-12,171,3.32592204444369,8,223,215
kandidat000110,Anne Dubrau,2015,mdg,37,57,Ikke valgt,176,15,26096,8.14,Miljøpartiet De Grønne,191,2015-09-14,161,2.28930087531065,4,161,157
kandidat000111,Anne Ebbing,2007,sv,40,57,Ikke valgt,142,12,28701,10.56,Sosialistisk Venstreparti,154,2007-09-10,7,1.99737684358518e-06,0,15,15
kandidat000112,Anne Haabeth Rygg,2007,h,8,7,Valgt,1432,52,68475,25.19,Høyre,1484,2007-09-10,129,0.537409138065983,1,132,131
kandidat000113,Anne Hege Tangen,2007,rv,42,29,Ikke valgt,64,4,14131,5.2,Rød Valgallianse,68,2007-09-10,5,1.68857575449071,2,10,8
kandidat000114,Anne Helen Hjelmerud,2015,frp,23,26,Ikke valgt,158,7,19311,6.03,Fremskrittspartiet,165,2015-09-14,15,2.03109740590456,3,38,35
kandidat000115,Anne Hollerud,2007,v,50,39,Ikke valgt,116,7,23703,8.72,Venstre,123,2007-09-10,2,2.65006244400094e-11,0,2,2
kandidat000116,Anne Ingebjørg Enge,2007,sp,23,14,Ikke valgt,21,0,2189,0.81,Senterpartiet,21,2007-09-10,9,0.432451831175056,1,14,13
kandidat000117,Anne Ingebjørg Enge,2011,sp,31,30,Ikke valgt,12,1,1591,0.51,Senterpartiet,13,2011-09-12,6,0.00567544137518025,0,20,20
kandidat000118,Anne Ingebjørg Enge,2015,sp,33,28,Ikke valgt,16,2,1926,0.6,Senterpartiet,18,2015-09-14,4,1.19555656115058e-09,0,24,24
kandidat000119,Anne-Karin Kjeldset,2007,v,58,44,Ikke valgt,96,2,23703,8.72,Venstre,98,2007-09-10,8,3.72919214022947,6,10,4
kandidat000120,Anne Karin Nygård,2007,ap,50,48,Ikke valgt,393,7,81265,29.89,Det norske Arbeiderparti,400,2007-09-10,48,4.23969897200024,8,68,60
kandidat000121,Anne-Lise Bergenheim,2007,v,28,22,Ikke valgt,207,9,23703,8.72,Venstre,216,2007-09-10,107,0.271010597199593,0,241,241
kandidat000122,Annelise Høegh,2007,h,3,5,Valgt,3732,190,68475,25.19,Høyre,3922,2007-09-10,293,12.9455481522933,24,2292,2268
kandidat000123,Annelise Høegh,2011,h,3,7,Valgt,2209,59,110776,35.7,Høyre,2268,2011-09-12,267,9.66980110490881,18,2559,2541
kandidat000124,Anne-Liv Gamlem,2007,ksp,1,1,Ikke valgt,18,15,158000,0.06,Kristent Samlingsparti,33,2007-09-10,59,4.41103480323592,19,70,51
kandidat000125,Anne-Liv Gamlem,2011,ksp,2,2,Ikke valgt,27,10,235000,0.08,Kristent Samlingsparti,37,2011-09-12,13,3.12689272081927,4,83,79
kandidat000126,Anne Louise Hübert,2007,krf,33,38,Ikke valgt,40,3,8368,3.08,Kristelig Folkeparti,43,2007-09-10,23,3.33284028637726,6,23,17
kandidat000127,Anne Louise Hübert,2011,krf,21,39,Ikke valgt,116,4,7571,2.44,Kristelig Folkeparti,120,2011-09-12,62,14.9132224590183,23,85,62
kandidat000128,Ann Elseth,2011,frp,33,27,Ikke valgt,103,7,21852,7.04,Fremskrittspartiet,110,2011-09-12,11,0.0503992167197065,0,20,20
kandidat000129,Anne Margrete Halvorsen,2011,sp,14,9,Ikke valgt,11,13,1591,0.51,Senterpartiet,24,2011-09-12,9,0.726626968786365,1,19,18
kandidat000130,Anne Mari Borg,2015,dem,2,5,Ikke valgt,69,2,740,0.23,Demokratene i Norge,71,NA,0,0,0,0,0
kandidat000131,Anne-Mari Borg,2011,pp,8,10,Ikke valgt,18,3,1045,0.34,Pensjonistpartiet,21,2011-09-12,1,1.19923127092213e-08,0,1,1
kandidat000132,Anne Marie Aanerud,2015,sp,31,32,Ikke valgt,18,1,1926,0.6,Senterpartiet,19,2015-09-14,216,2.65377700823698,5,219,214
kandidat000133,Anne Marie Leirfall,2007,sp,13,19,Ikke valgt,31,5,2189,0.81,Senterpartiet,36,2007-09-10,7,0.00496396597833956,0,36,36
kandidat000134,Anne Marie Leirfall,2011,sp,48,40,Ikke valgt,8,0,1591,0.51,Senterpartiet,8,2011-09-12,11,0.341757651855024,2,47,45
kandidat000135,Anne Marie Leirfall,2015,sp,18,19,Ikke valgt,36,1,1926,0.6,Senterpartiet,37,2015-09-14,4,3.13308633104207e-06,0,51,51
kandidat000136,Anne Nyeggen,2011,ap,53,63,Ikke valgt,403,33,102707,33.1,Det norske Arbeiderparti,436,2011-09-12,109,3.09014370673232,7,263,256
kandidat000137,Anne Nyeggen,2015,ap,46,34,Ikke valgt,811,36,102431,31.97,Arbeiderpartiet,847,2015-09-14,138,3.14499341507287,8,401,393
kandidat000138,Anne Siri Koksrud,2011,v,33,45,Ikke valgt,133,12,25351,8.17,Venstre,145,2011-09-12,73,12.1214087060895,32,73,41
kandidat000139,Anne Siri Koksrud Bekkelund,2015,v,17,21,Ikke valgt,247,22,21986,6.86,Venstre,269,2015-09-14,159,1.04853867224878,1,159,158
kandidat000140,Anne-Turid Steinsvik,2007,h,49,55,Ikke valgt,235,7,68475,25.19,Høyre,242,2007-09-10,8,0.813480701880094,1,22,21
kandidat000141,Anniken Harlem Thorsen,2011,sv,22,13,Ikke valgt,204,18,19477,6.28,Sosialistisk Venstreparti,222,2011-09-12,2,4.44001492766068e-06,0,2,2
kandidat000142,Anniken Hauglie,2011,h,9,9,Valgt,1252,40,110776,35.7,Høyre,1292,2011-09-12,556,51.647799724874,98,613,515
kandidat000143,Anni Onsager,2011,mdg,64,60,Ikke valgt,15,0,7653,2.47,Miljøpartiet De Grønne,15,2011-09-12,7,0.000251763041473391,0,80,80
kandidat000144,Ann-Katrin Vemer Krogh,2007,dem,2,2,Ikke valgt,26,5,306000,0.11,Demokratene,31,NA,0,0,0,0,0
kandidat000145,Ann-Mari Røng,2007,krf,23,18,Ikke valgt,56,11,8368,3.08,Kristelig Folkeparti,67,2007-09-10,1,0.676380156039289,1,8,7
kandidat000146,Ann-Mari Røng,2011,krf,30,16,Ikke valgt,67,10,7571,2.44,Kristelig Folkeparti,77,2011-09-12,4,1.72331560416759,3,12,9
kandidat000147,Aref Joian,2007,rv,51,55,Ikke valgt,36,4,14131,5.2,Rød Valgallianse,40,2007-09-10,6,0.000156326766020591,0,6,6
kandidat000148,Arild Andersson,2007,h,28,11,Vara,528,14,68475,25.19,Høyre,542,2007-09-10,56,4.26622274430945,9,64,55
kandidat000149,Arild Knutsen,2007,osby,4,9,Ikke valgt,94,68,1466,0.54,Oslo Byaksjon,162,2007-09-10,343,20.2140549948902,48,527,479
kandidat000150,Arild Sverstad Haug,2015,sv,55,32,Ikke valgt,51,3,17445,5.44,Sosialistisk Venstreparti,54,2015-09-14,2,0,0,5,5
kandidat000151,Arild T. Aukrust,2007,h,30,14,Vara,462,8,68475,25.19,Høyre,470,2007-09-10,1,0.91210514954509,1,1,0
kandidat000152,Aril Ringerike,2007,ksp,7,5,Ikke valgt,7,2,158000,0.06,Kristent Samlingsparti,9,NA,0,0,0,0,0
kandidat000153,Arne Aarsæther,2007,sfp,11,4,Ikke valgt,6,1,129000,0.05,Samfunnspartiet,7,2007-09-10,2,0.794533779346954,1,10,9
kandidat000154,Arne Bye,2007,pp,32,23,Ikke valgt,5,1,1414,0.52,Pensjonistpartiet,6,2007-09-10,126,2.22009564570273,5,485,480
kandidat000155,Arne Bye,2011,pp,11,12,Ikke valgt,13,4,1045,0.34,Pensjonistpartiet,17,2011-09-12,368,3.32143087463334,11,853,842
kandidat000156,Arne Herman Rolijordet,2007,rv,57,61,Ikke valgt,32,3,14131,5.2,Rød Valgallianse,35,2007-09-10,7,0.0524097370134576,0,7,7
kandidat000157,Arne Herman Rolijordet,2011,rv,56,38,Ikke valgt,38,2,11257,3.63,Rødt,40,2011-09-12,1,0.977262483773277,1,8,7
kandidat000158,Arne Johan Valen-Sendstad,2007,osby,35,44,Ikke valgt,12,6,1466,0.54,Oslo Byaksjon,18,2007-09-10,1,1.9640744487877e-12,0,1,1
kandidat000159,Arne Jørgensen,2007,nkp,5,10,Ikke valgt,8,11,203000,0.07,Norges Kommunistiske Parti,19,2007-09-10,230,12.1578202687423,34,862,828
kandidat000160,Arne Jørgensen,2011,nkp,7,15,Ikke valgt,15,3,210000,0.07,Norges Kommunistiske Parti,18,2011-09-12,817,38.8548105315043,80,1679,1599
kandidat000161,Arne Jørgensen,2015,nkp,4,13,Ikke valgt,18,12,240,0.07,Norges Kommunistiske Parti,30,2015-09-14,1612,22.2947609771328,50,3291,3241
kandidat000162,Arne Løining,2007,mdg,1,1,Ikke valgt,252,299,1687,0.62,Miljøpartiet De Grønne,551,2007-09-10,3,2.2561110680776,3,5,2
kandidat000163,Arne Næss,2007,mdg,11,65,Ikke valgt,75,28,1687,0.62,Miljøpartiet De Grønne,103,2007-09-10,3001,111.455483819024,269,7156,6887
kandidat000164,Arne Rolijordet,2015,rv,40,21,Ikke valgt,120,6,16174,5.05,Rødt,126,2015-09-14,44,0.301060023212181,1,299,298
kandidat000165,Arne Styhr,2011,dem,21,28,Ikke valgt,3,0,214000,0.07,Demokratene i Norge,3,2011-09-12,9,6.94017781576165e-10,0,36,36
kandidat000166,Arne Toften,2007,kp,30,40,Ikke valgt,2,0,120000,0.04,Kystpartiet,2,2007-09-10,36,0.00148886520245932,0,57,57
kandidat000167,Arne Vesterlid,2007,mdg,50,29,Ikke valgt,6,0,1687,0.62,Miljøpartiet De Grønne,6,2007-09-10,5,0.00798734169111973,0,32,32
kandidat000168,Arnfinn Olav Solli,2011,pp,24,22,Ikke valgt,8,2,1045,0.34,Pensjonistpartiet,10,NA,0,0,0,0,0
kandidat000169,Arnfinn Olav Solli,2015,pp,22,22,Ikke valgt,9,0,1169,0.36,Pensjonistpartiet,9,NA,0,0,0,0,0
kandidat000170,Arnt Folgerø,2007,sfp,17,9,Ikke valgt,4,0,129000,0.05,Samfunnspartiet,4,2007-09-10,1143,33.0588992824502,99,3169,3070
kandidat000171,Arshad Mubarak Ali,2015,ap,42,51,Vara,1056,18,102431,31.97,Arbeiderpartiet,1074,2015-09-14,20,0.582519824768146,2,89,87
kandidat000172,Arve Bakken,2007,kp,42,9,Ikke valgt,0,0,120000,0.04,Kystpartiet,0,2007-09-10,54,0.173217899607622,0,93,93
kandidat000173,Arve Lønnum,2007,frp,16,50,Vara,237,31,38873,14.3,Fremskrittspartiet,268,2007-09-10,80,5.89144186802831,16,1185,1169
kandidat000174,Arve Lønnum,2015,frp,17,33,Ikke valgt,173,36,19311,6.03,Fremskrittspartiet,209,2015-09-14,369,3.07227166651041,10,1693,1683
kandidat000175,Arvid Arnold Austad,2007,dem,49,36,Ikke valgt,0,0,306000,0.11,Demokratene,0,NA,0,0,0,0,0
kandidat000176,Arvid Ellingsen,2011,sv,43,28,Ikke valgt,97,19,19477,6.28,Sosialistisk Venstreparti,116,2011-09-12,140,0.578214033971694,2,355,353
kandidat000177,Asbjørn Ulsberg,2015,pirat,12,8,Ikke valgt,23,6,805,0.25,Piratpartiet,29,2015-09-14,1,1.62136086534843e-09,0,4,4
kandidat000178,Åse Garten Galtrud,2007,rv,8,8,Vara,265,9,14131,5.2,Rød Valgallianse,274,2007-09-10,3,2.45691647894858e-08,0,4,4
kandidat000179,Åse Rellsve,2011,sv,51,49,Ikke valgt,79,2,19477,6.28,Sosialistisk Venstreparti,81,2011-09-12,2,5.39353701668379e-08,0,12,12
kandidat000180,Åse Tveiten,2011,v,61,61,Ikke valgt,50,1,25351,8.17,Venstre,51,2011-09-12,6,0.000802403960316435,0,42,42
kandidat000181,Åse Tveiten,2015,v,60,57,Ikke valgt,73,4,21986,6.86,Venstre,77,2015-09-14,13,0.680936418096218,1,55,54
kandidat000182,Åshild Lappegård Lahn,2015,rv,21,16,Ikke valgt,245,21,16174,5.05,Rødt,266,2015-09-14,85,1.94525108724406,5,471,466
kandidat000183,Åshild Olaussen,2015,sv,41,51,Ikke valgt,139,7,17445,5.44,Sosialistisk Venstreparti,146,2015-09-14,29,0.285146089513567,2,56,54
kandidat000184,Åshild Schmidt,2007,krf,17,8,Ikke valgt,76,7,8368,3.08,Kristelig Folkeparti,83,2007-09-10,14,0.0301720732337906,0,17,17
kandidat000185,Aslak Aslaksen,2007,h,22,13,Vara,681,35,68475,25.19,Høyre,716,2007-09-10,25,1.25258758061777,2,68,66
kandidat000186,Aslak Aslaksen,2011,h,27,12,Vara,699,19,110776,35.7,Høyre,718,2011-09-12,56,1.35580403331194,6,124,118
kandidat000187,Aslak Aslaksen,2015,h,54,39,Ikke valgt,318,16,101882,31.8,Høyre,334,2015-09-14,111,0.678059616371892,2,235,233
kandidat000188,Aslak Nore,2007,osby,20,63,Ikke valgt,17,13,1466,0.54,Oslo Byaksjon,30,2007-09-10,501,19.0364430531985,37,586,549
kandidat000189,Aslak Sira Myhre,2007,rv,11,63,Ikke valgt,462,88,14131,5.2,Rød Valgallianse,550,2007-09-10,959,40.5625602875108,62,2532,2470
kandidat000190,Aslak Sira Myhre,2011,rv,14,56,Ikke valgt,383,87,11257,3.63,Rødt,470,2011-09-12,1722,27.2883015229881,86,4254,4168
kandidat000191,Aslak Sira Myhre,2015,rv,11,63,Ikke valgt,726,117,16174,5.05,Rødt,843,2015-09-14,2749,115.770192370405,231,7003,6772
kandidat000192,Aslak Syse,2015,sv,32,46,Ikke valgt,165,41,17445,5.44,Sosialistisk Venstreparti,206,2015-09-14,628,10.2853384621636,25,1603,1578
kandidat000193,Aslaug Unneberg,2011,sp,51,51,Ikke valgt,6,1,1591,0.51,Senterpartiet,7,2011-09-12,2,0.0030184628406133,0,3,3
kandidat000194,Åsmund Strand Johansen,2007,sv,34,23,Ikke valgt,184,9,28701,10.56,Sosialistisk Venstreparti,193,2007-09-10,17,0.769751382486155,5,26,21
kandidat000195,Åsmund Strand Johansen,2011,sv,24,16,Ikke valgt,200,17,19477,6.28,Sosialistisk Venstreparti,217,2011-09-12,4,0.162512658561377,1,30,29
kandidat000196,Astrid Beate Sveen,2011,pp,18,23,Ikke valgt,10,4,1045,0.34,Pensjonistpartiet,14,NA,0,0,0,0,0
kandidat000197,Astrid Charlotte Seeberg,2007,v,19,12,Ikke valgt,310,26,23703,8.72,Venstre,336,NA,0,0,0,0,0
kandidat000198,Astrid Charlotte Seeberg,2011,v,46,56,Ikke valgt,87,4,25351,8.17,Venstre,91,2011-09-12,6,1.38579462374326e-08,0,6,6
kandidat000199,Astrid Midtbø,2011,mdg,14,12,Ikke valgt,88,10,7653,2.47,Miljøpartiet De Grønne,98,2011-09-12,4,0.0060630785172214,0,7,7
kandidat000200,Aud Kristine Johnsen,2007,sv,45,37,Ikke valgt,139,0,28701,10.56,Sosialistisk Venstreparti,139,2007-09-10,3,0.93060132797865,1,3,2
kandidat000201,Aud Krogh Skaugen,2011,v,59,58,Ikke valgt,52,4,25351,8.17,Venstre,56,NA,0,0,0,0,0
kandidat000202,Aud Krogh Skaugen,2015,v,59,50,Ikke valgt,75,6,21986,6.86,Venstre,81,2015-09-14,1,0,0,1,1
kandidat000203,Aud Kvalbein,2007,krf,1,1,Valgt,1329,265,8368,3.08,Kristelig Folkeparti,1594,2007-09-10,596,141.814952959003,210,693,483
kandidat000204,Aud Kvalbein,2011,krf,1,1,Valgt,1583,243,7571,2.44,Kristelig Folkeparti,1826,2011-09-12,2106,152.538728722974,210,2799,2589
kandidat000205,Aud Kvalbein,2015,krf,4,57,Vara,390,28,7827,2.44,Kristelig Folkeparti,418,2015-09-14,1896,111.254171232592,178,4695,4517
kandidat000206,Aud Turid Erdal,2011,pp,16,19,Ikke valgt,14,1,1045,0.34,Pensjonistpartiet,15,NA,0,0,0,0,0
kandidat000207,Audun Herning,2007,sv,13,11,Vara,627,74,28701,10.56,Sosialistisk Venstreparti,701,2007-09-10,833,5.27894188241416,9,844,835
kandidat000208,Audun Rødningsby,2007,v,15,8,Ikke valgt,408,37,23703,8.72,Venstre,445,2007-09-10,124,1.71044123168637,2,134,132
kandidat000209,Audun Rødningsby,2011,v,16,9,Ikke valgt,241,23,25351,8.17,Venstre,264,2011-09-12,194,1.96905441019472,3,328,325
kandidat000210,Audun Skjelvan,2007,kp,11,36,Ikke valgt,1,4,120000,0.04,Kystpartiet,5,2007-09-10,1,0.00409905016165521,0,4,4
kandidat000211,Avigaiel Sholamit Ohana,2007,pp,17,13,Ikke valgt,9,2,1414,0.52,Pensjonistpartiet,11,NA,0,0,0,0,0
kandidat000212,Axel Fougner,2007,v,35,33,Ikke valgt,173,15,23703,8.72,Venstre,188,2007-09-10,7,1.3127308263728e-09,0,7,7
kandidat000213,Axel Stang Laache,2011,kp,18,16,Ikke valgt,2,0,126000,0.04,Kystpartiet,2,NA,0,0,0,0,0
kandidat000214,Axel Storebø,2011,krf,40,48,Ikke valgt,45,16,7571,2.44,Kristelig Folkeparti,61,2011-09-12,13,1.86473786146987,5,13,8
kandidat000215,Ayan Ali,2015,rv,23,23,Ikke valgt,188,21,16174,5.05,Rødt,209,2015-09-14,1,4.01728462877544e-13,0,11,11
kandidat000216,Ayesha Wolasmal,2011,ap,34,51,Vara,824,44,102707,33.1,Det norske Arbeiderparti,868,2011-09-12,21,0.785680788834324,3,23,20
kandidat000217,Ayser Farhad,2011,rv,49,45,Ikke valgt,52,4,11257,3.63,Rødt,56,2011-09-12,1,0.977262483773277,1,1,0
kandidat000218,Ayser Yüce Farhad,2015,rv,41,25,Ikke valgt,113,8,16174,5.05,Rødt,121,NA,0,0,0,0,0
kandidat000219,Baghi Taleb Ol Elm,2015,rv,56,31,Ikke valgt,81,3,16174,5.05,Rødt,84,2015-09-14,1,2.7518291525443e-09,0,70,70
kandidat000220,Balwinder Kaur,2007,sv,6,8,Valgt,943,128,28701,10.56,Sosialistisk Venstreparti,1071,2007-09-10,6,0.0278158799411297,0,16,16
kandidat000221,Balwinder Kaur,2011,sv,10,11,Vara,342,95,19477,6.28,Sosialistisk Venstreparti,437,2011-09-12,29,1.18856906526419,2,45,43
kandidat000222,Bård Alexander Meringen,2011,dem,5,17,Ikke valgt,3,6,214000,0.07,Demokratene i Norge,9,2011-09-12,1,0.00711891466406466,0,1,1
kandidat000223,Bård Folke Fredriksen,2007,h,4,4,Valgt,2120,105,68475,25.19,Høyre,2225,2007-09-10,844,227.347801468813,363,1937,1574
kandidat000224,Bård Folke Fredriksen,2011,h,5,4,Valgt,2015,83,110776,35.7,Høyre,2098,2011-09-12,1568,92.2507796500903,176,3505,3329
kandidat000225,Bård Folke Fredriksen,2015,h,4,4,Valgt,2477,128,101882,31.8,Høyre,2605,2015-09-14,3082,92.0448584998278,190,6587,6397
kandidat000226,Bård Inge Solheim,2007,mdg,55,27,Ikke valgt,5,0,1687,0.62,Miljøpartiet De Grønne,5,NA,0,0,0,0,0
kandidat000227,Bård Torgersen,2007,osby,21,43,Ikke valgt,19,10,1466,0.54,Oslo Byaksjon,29,2007-09-10,197,7.74466183589295,10,266,256
kandidat000228,Bashe Musse,2011,ap,15,58,Valgt,2246,25,102707,33.1,Det norske Arbeiderparti,2271,2011-09-12,480,27.3400867046548,71,716,645
kandidat000229,Bashe Musse,2015,ap,24,61,Vara,2158,41,102431,31.97,Arbeiderpartiet,2199,2015-09-14,336,0.123617078923479,0,1052,1052
kandidat000230,Bastian Winde Harbo,2015,lib,1,1,Ikke valgt,99,37,458,0.14,Liberalistene Oslo,136,2015-09-14,84,13.6942889387469,24,88,64
kandidat000231,Beate Bruun,2015,sv,31,29,Ikke valgt,196,21,17445,5.44,Sosialistisk Venstreparti,217,2015-09-14,25,0.0439123558240559,0,44,44
kandidat000232,Beate Folkestad Habhab,2015,mdg,4,3,Valgt,1146,201,26096,8.14,Miljøpartiet De Grønne,1347,2015-09-14,22,2.00956889038168,5,45,40
kandidat000233,Beate Holland,2015,frp,26,28,Ikke valgt,140,8,19311,6.03,Fremskrittspartiet,148,2015-09-14,107,7.7478171360827e-05,0,113,113
kandidat000234,Beate Homlong,2007,sp,17,11,Ikke valgt,29,3,2189,0.81,Senterpartiet,32,2007-09-10,6,0.00492712324384607,0,8,8
kandidat000235,Beate Homlong,2011,sp,27,15,Ikke valgt,11,3,1591,0.51,Senterpartiet,14,2011-09-12,12,0.163489185856544,0,20,20
kandidat000236,Beate Homlong,2015,sp,47,36,Ikke valgt,7,2,1926,0.6,Senterpartiet,9,2015-09-14,3,1.34643307550573e-10,0,23,23
kandidat000237,Beate Mikalsen,2007,h,57,45,Ikke valgt,197,3,68475,25.19,Høyre,200,2007-09-10,2,0.371603251795273,1,2,1
kandidat000238,Beate Svenningsen,2007,ap,29,24,Vara,722,79,81265,29.89,Det norske Arbeiderparti,801,2007-09-10,6,0.842799174195979,2,18,16
kandidat000239,Beatrice Halsaa,2011,sv,50,45,Ikke valgt,80,4,19477,6.28,Sosialistisk Venstreparti,84,2011-09-12,53,0.0741304419403324,0,139,139
kandidat000240,Beatrice Solomon Gill,2011,ksp,3,4,Ikke valgt,13,8,235000,0.08,Kristent Samlingsparti,21,2011-09-12,1,1.06895415361435e-08,0,1,1
kandidat000241,Ben Bjørke,2007,osby,41,26,Ikke valgt,7,6,1466,0.54,Oslo Byaksjon,13,2007-09-10,1,0.3024014015295,1,1,0
kandidat000242,Ben Borgen,2011,rv,50,60,Ikke valgt,45,8,11257,3.63,Rødt,53,2011-09-12,331,2.60215330315309,5,727,722
kandidat000243,Ben Borgen,2015,rv,50,53,Ikke valgt,83,20,16174,5.05,Rødt,103,2015-09-14,37,0.115280486850829,0,764,764
kandidat000244,Benedicte Alnæs,2015,fi,9,6,Ikke valgt,42,27,1388,0.43,Feministisk Initiativ,69,2015-09-14,12,0.16975273967201,0,12,12
kandidat000245,Benedicte I. Brynsrud Sjøflot,2011,v,42,57,Ikke valgt,97,7,25351,8.17,Venstre,104,NA,0,0,0,0,0
kandidat000246,Benedikte Tollefsen-Minos,2007,krf,4,3,Vara,551,76,8368,3.08,Kristelig Folkeparti,627,2007-09-10,1,0.479026193188751,1,2,1
kandidat000247,Benedikte Tollefsen-Minos,2011,krf,7,14,Ikke valgt,235,14,7571,2.44,Kristelig Folkeparti,249,2011-09-12,22,7.25848084454221e-07,0,24,24
kandidat000248,Benedikte Tollefsen-Minos,2015,krf,15,43,Ikke valgt,136,8,7827,2.44,Kristelig Folkeparti,144,NA,0,0,0,0,0
kandidat000249,Benjamin Endré Larsen,2011,sv,14,10,Ikke valgt,293,59,19477,6.28,Sosialistisk Venstreparti,352,2011-09-12,37,0.398218611001283,1,52,51
kandidat000250,Benjamin Endré Larsen,2015,sv,8,4,Vara,560,137,17445,5.44,Sosialistisk Venstreparti,697,2015-09-14,43,4.73527365893831,6,95,89
kandidat000251,Benjamin Jonsrud,2007,sv,44,52,Ikke valgt,115,26,28701,10.56,Sosialistisk Venstreparti,141,2007-09-10,41,1.61766752078932,2,41,39
kandidat000252,Benjamin Myklebust,2011,mdg,45,39,Ikke valgt,30,8,7653,2.47,Miljøpartiet De Grønne,38,2011-09-12,21,2.73325042675709,5,24,19
kandidat000253,Bente Johnsen,2011,dem,4,3,Ikke valgt,8,5,214000,0.07,Demokratene i Norge,13,2011-09-12,84,1.19563064013616,2,212,210
kandidat000254,Bente-Marie Nørgård,2015,v,55,47,Ikke valgt,86,4,21986,6.86,Venstre,90,2015-09-14,14,0.00842752265172924,0,39,39
kandidat000255,Bente M Larsen,2015,ap,41,28,Vara,1028,47,102431,31.97,Arbeiderpartiet,1075,2015-09-14,21,1.68556350709325,2,35,33
kandidat000256,Bente Moseng,2007,rv,49,44,Ikke valgt,39,4,14131,5.2,Rød Valgallianse,43,2007-09-10,2,0.865106270336455,2,8,6
kandidat000257,Bente Schjelderup With,2011,kp,6,20,Ikke valgt,6,1,126000,0.04,Kystpartiet,7,NA,0,0,0,0,0
kandidat000258,Benthe Lill Krigerød,2015,rv,52,43,Ikke valgt,95,5,16174,5.05,Rødt,100,2015-09-14,7,0.000519637314005564,0,20,20
kandidat000259,Bent Trulsrud Nord,2007,h,60,46,Ikke valgt,170,11,68475,25.19,Høyre,181,2007-09-10,1,0.00142298286700444,0,2,2
kandidat000260,Beret Werner,2007,rv,50,60,Ikke valgt,38,4,14131,5.2,Rød Valgallianse,42,2007-09-10,22,2.32863425440956,10,22,12
kandidat000261,Beret Werner,2011,rv,44,50,Ikke valgt,57,7,11257,3.63,Rødt,64,2011-09-12,271,2.41793595999691,5,293,288
kandidat000262,Berit Gjerull,2007,krf,41,33,Ikke valgt,28,2,8368,3.08,Kristelig Folkeparti,30,NA,0,0,0,0,0
kandidat000263,Berit Jagmann,2007,rv,26,31,Ikke valgt,132,7,14131,5.2,Rød Valgallianse,139,2007-09-10,25,2.84073862437075,3,314,311
kandidat000264,Berit Jensen Riis,2007,frp,9,10,Valgt,512,17,38873,14.3,Fremskrittspartiet,529,2007-09-10,5,1.85044917282921,2,5,3
kandidat000265,Berit Jensen Riis,2011,frp,21,14,Ikke valgt,127,24,21852,7.04,Fremskrittspartiet,151,2011-09-12,42,3.10708551581978,4,47,43
kandidat000266,Berit Kraft,2007,pp,4,4,Ikke valgt,29,3,1414,0.52,Pensjonistpartiet,32,NA,0,0,0,0,0
kandidat000267,Berit Kraft,2011,pp,10,8,Ikke valgt,16,1,1045,0.34,Pensjonistpartiet,17,2011-09-12,1,1.19923127092213e-08,0,1,1
kandidat000268,Berit Kraft,2015,pp,11,7,Ikke valgt,19,2,1169,0.36,Pensjonistpartiet,21,NA,0,0,0,0,0
kandidat000269,Berit Kvæven,2007,v,20,16,Ikke valgt,257,29,23703,8.72,Venstre,286,2007-09-10,28,1.51634566551283,2,221,219
kandidat000270,Berit Kvæven,2015,v,49,43,Ikke valgt,97,7,21986,6.86,Venstre,104,2015-09-14,82,0.0175971265104205,0,348,348
kandidat000271,Berit Laukholm,2011,pp,21,27,Ikke valgt,10,1,1045,0.34,Pensjonistpartiet,11,2011-09-12,1,2.56172470349606e-08,0,2,2
kandidat000272,Berit Lovise Aspelund,2007,pp,30,30,Ikke valgt,7,0,1414,0.52,Pensjonistpartiet,7,NA,0,0,0,0,0
kandidat000273,Berit Mouna,2007,pp,24,29,Ikke valgt,8,1,1414,0.52,Pensjonistpartiet,9,NA,0,0,0,0,0
kandidat000274,Berit Solli,2011,h,43,52,Vara,433,21,110776,35.7,Høyre,454,2011-09-12,67,4.55436542758217,6,605,599
kandidat000275,Berit Vaage,2011,pp,22,31,Ikke valgt,10,1,1045,0.34,Pensjonistpartiet,11,2011-09-12,7,0.109472551524752,1,7,6
kandidat000276,Beth Hartmann,2007,rv,60,58,Ikke valgt,32,2,14131,5.2,Rød Valgallianse,34,2007-09-10,17,1.827047849912,2,17,15
kandidat000277,Bettina Thorvik,2011,ap,10,7,Valgt,1789,60,102707,33.1,Det norske Arbeiderparti,1849,2011-09-12,166,14.2751588482006,52,189,137
kandidat000278,Birgit Skarstein,2015,ap,21,24,Vara,2559,163,102431,31.97,Arbeiderpartiet,2722,2015-09-14,2925,121.039194132729,206,2934,2728
kandidat000279,Bjarne Benjaminsen,2007,mdg,62,55,Ikke valgt,2,1,1687,0.62,Miljøpartiet De Grønne,3,2007-09-10,4,0.0203021039549271,0,7,7
kandidat000280,Bjarne Kristian Widsteen,2007,dem,54,52,Ikke valgt,0,0,306000,0.11,Demokratene,0,NA,0,0,0,0,0
kandidat000281,Bjarne Kristoffersen,2011,sv,46,38,Ikke valgt,91,6,19477,6.28,Sosialistisk Venstreparti,97,2011-09-12,150,4.61295282068604,5,520,515
kandidat000282,Bjarne Kristoffersen,2015,sv,26,16,Ikke valgt,209,31,17445,5.44,Sosialistisk Venstreparti,240,2015-09-14,218,5.66879517574462,13,738,725
kandidat000283,Bjarne Mork,2007,dem,51,41,Ikke valgt,0,0,306000,0.11,Demokratene,0,2007-09-10,4,0.190875572435063,1,21,20
kandidat000284,Bjarne Ødegaard,2007,h,21,64,Vara,661,56,68475,25.19,Høyre,717,2007-09-10,170,11.6636388209416,22,223,201
kandidat000285,Bjørg Karlsen,2015,pp,15,18,Ikke valgt,16,2,1169,0.36,Pensjonistpartiet,18,2015-09-14,138,3.40109749117349,5,318,313
kandidat000286,Bjørg Sandkjær,2015,sp,6,6,Ikke valgt,55,26,1926,0.6,Senterpartiet,81,2015-09-14,38,0.101782358097438,0,47,47
kandidat000287,Bjørg Vårvik,2007,sp,39,34,Ikke valgt,8,2,2189,0.81,Senterpartiet,10,2007-09-10,1,0.00492712315397501,0,5,5
kandidat000288,Bjørn Aagenæs,2007,osby,59,51,Ikke valgt,1,4,1466,0.54,Oslo Byaksjon,5,2007-09-10,27,0.505350743032005,2,45,43
kandidat000289,Bjørn A. Lundberg,2007,ap,10,7,Valgt,1471,68,81265,29.89,Det norske Arbeiderparti,1539,2007-09-10,2,8.33646086067742e-05,0,4,4
kandidat000290,Bjørn A. Lundberg,2011,ap,23,12,Vara,1125,42,102707,33.1,Det norske Arbeiderparti,1167,2011-09-12,3,0.97726416834365,1,7,6
kandidat000291,Bjørnar Bakker,2007,sp,50,38,Ikke valgt,5,1,2189,0.81,Senterpartiet,6,2007-09-10,1,0.00492712315397501,0,2,2
kandidat000292,Bjørnar Moxnes,2007,rv,4,6,Vara,499,112,14131,5.2,Rød Valgallianse,611,2007-09-10,298,1.09107976738917,1,310,309
kandidat000293,Bjørnar Moxnes,2011,rv,1,1,Valgt,2011,1166,11257,3.63,Rødt,3177,2011-09-12,766,100.585812679096,158,1076,918
kandidat000294,Bjørnar Moxnes,2015,rv,1,1,Valgt,5533,3118,16174,5.05,Rødt,8651,2015-09-14,7359,412.210501031428,685,8435,7750
kandidat000295,Bjørn Borge-Lunde,2007,frp,18,12,Vara,250,7,38873,14.3,Fremskrittspartiet,257,2007-09-10,5,0.219163218272407,1,6,5
kandidat000296,Bjørn Børre Børresen,2007,pp,20,18,Ikke valgt,10,0,1414,0.52,Pensjonistpartiet,10,NA,0,0,0,0,0
kandidat000297,Bjørn Brunstad,2011,mdg,60,53,Ikke valgt,17,2,7653,2.47,Miljøpartiet De Grønne,19,2011-09-12,35,0.417635612938966,2,104,102
kandidat000298,Bjørn Christian Borch,2007,kp,5,11,Ikke valgt,5,4,120000,0.04,Kystpartiet,9,2007-09-10,9,6.61087795110156,8,15,7
kandidat000299,Bjørn Christian Borch,2011,kp,2,2,Ikke valgt,13,6,126000,0.04,Kystpartiet,19,2011-09-12,2,4.85262500963396e-06,0,17,17
kandidat000300,Bjørn Christian Borch,2015,kp,11,3,Ikke valgt,3,3,124,0.04,Kystpartiet,6,2015-09-14,14,4.42743340068128e-07,0,31,31
kandidat000301,Bjørn Gunnar Myhrvold,2015,frp,28,19,Ikke valgt,133,6,19311,6.03,Fremskrittspartiet,139,NA,0,0,0,0,0
kandidat000302,Bjørn Hansen,2011,ap,59,46,Ikke valgt,371,13,102707,33.1,Det norske Arbeiderparti,384,2011-09-12,8333,177.608348998994,402,19837,19435
kandidat000303,Bjørn Helge Loe,2007,dem,6,45,Ikke valgt,1,13,306000,0.11,Demokratene,14,NA,0,0,0,0,0
kandidat000304,Bjørn Lie Fostad,2007,nkp,18,18,Ikke valgt,6,1,203000,0.07,Norges Kommunistiske Parti,7,NA,0,0,0,0,0
kandidat000305,Bjørn Pedersen,2011,pp,26,26,Ikke valgt,9,0,1045,0.34,Pensjonistpartiet,9,2011-09-12,903,20.4378630287991,42,2814,2772
kandidat000306,Bjørn Ragnar Nordengen,2015,rv,64,55,Ikke valgt,38,9,16174,5.05,Rødt,47,NA,0,0,0,0,0
kandidat000307,Bjørn Tore Egeberg,2011,rv,45,27,Ikke valgt,55,5,11257,3.63,Rødt,60,2011-09-12,129,0.993840894137614,6,148,142
kandidat000308,Bjørn Wigernæs,2007,krf,60,60,Ikke valgt,21,2,8368,3.08,Kristelig Folkeparti,23,2007-09-10,2,0.577612055771911,2,14,12
kandidat000309,Bjørn Wigernæs,2015,krf,52,54,Ikke valgt,25,2,7827,2.44,Kristelig Folkeparti,27,2015-09-14,5,1.72239076285684,2,19,17
kandidat000310,Bodil Erichsen,2007,sv,53,55,Ikke valgt,110,4,28701,10.56,Sosialistisk Venstreparti,114,2007-09-10,2,9.45471072269544e-06,0,3,3
kandidat000311,Børge Einrem,2011,sp,16,29,Ikke valgt,15,6,1591,0.51,Senterpartiet,21,2011-09-12,105,0.74457519659456,4,847,843
kandidat000312,Børge Einrem,2015,sp,51,42,Ikke valgt,6,1,1926,0.6,Senterpartiet,7,2015-09-14,91,0.00196176941209726,0,938,938
kandidat000313,Børge Svanstrøm Amundsen,2007,dlf,11,10,Ikke valgt,2,2,127000,0.05,Det Liberale Folkepartiet,4,2007-09-10,3,1.93349027032637e-06,0,10,10
kandidat000314,Boye Ullmann,2007,rv,17,18,Ikke valgt,181,26,14131,5.2,Rød Valgallianse,207,2007-09-10,232,3.07651616231837,9,467,458
kandidat000315,Boye Ullmann,2011,rv,36,44,Ikke valgt,77,8,11257,3.63,Rødt,85,2011-09-12,129,1.07419987209022,1,596,595
kandidat000316,Boye Ullmann,2015,rv,27,59,Ikke valgt,150,22,16174,5.05,Rødt,172,2015-09-14,413,9.13394491551944,17,1009,992
kandidat000317,Brage Baklien,2011,frp,36,31,Ikke valgt,94,9,21852,7.04,Fremskrittspartiet,103,2011-09-12,55,15.0136632827004,22,83,61
kandidat000318,Brage Lie Jor,2015,sv,35,24,Ikke valgt,159,25,17445,5.44,Sosialistisk Venstreparti,184,2015-09-14,4,0.0935742537959078,1,5,4
kandidat000319,Brigitte Andersen Alnæs,2011,v,25,19,Ikke valgt,191,9,25351,8.17,Venstre,200,NA,0,0,0,0,0
kandidat000320,Brit Andreassen,2007,h,5,3,Valgt,2032,62,68475,25.19,Høyre,2094,2007-09-10,133,8.11817473911235,13,242,229
kandidat000321,Brit Parma,2007,pp,21,32,Ikke valgt,8,2,1414,0.52,Pensjonistpartiet,10,NA,0,0,0,0,0
kandidat000322,Brit Parma,2011,pp,28,16,Ikke valgt,6,2,1045,0.34,Pensjonistpartiet,8,NA,0,0,0,0,0
kandidat000323,Brit Rasmussen,2007,kp,17,31,Ikke valgt,1,2,120000,0.04,Kystpartiet,3,2007-09-10,5,1.00795904300039,2,7,5
kandidat000324,Britt Bekkedal,2007,sv,30,31,Ikke valgt,202,20,28701,10.56,Sosialistisk Venstreparti,222,2007-09-10,1,1.6763288749646e-13,0,3,3
kandidat000325,Brit Teien,2007,h,56,58,Ikke valgt,200,2,68475,25.19,Høyre,202,2007-09-10,49,0.284862587476126,1,61,60
kandidat000326,Brit Teien,2011,h,65,60,Ikke valgt,197,7,110776,35.7,Høyre,204,2011-09-12,21,2.15357220040807,3,82,79
kandidat000327,Britt Inglingstad,2011,v,51,41,Ikke valgt,70,17,25351,8.17,Venstre,87,2011-09-12,64,2.53167757155956,6,69,63
kandidat000328,Britt Inglingstad,2015,v,40,37,Ikke valgt,120,6,21986,6.86,Venstre,126,2015-09-14,62,2.00054851453861,3,131,128
kandidat000329,Brynjar Selseth,2007,sfp,13,18,Ikke valgt,5,2,129000,0.05,Samfunnspartiet,7,NA,0,0,0,0,0
kandidat000330,Camilla Carlsson,2011,sp,18,19,Ikke valgt,15,4,1591,0.51,Senterpartiet,19,2011-09-12,8,0.902387124205119,1,39,38
kandidat000331,Camilla Pedersen,2007,da,2,2,Ikke valgt,20,11,191000,0.07,Demokratisk Alternativ for Oslo,31,2007-09-10,110,4.35434004924323,11,218,207
kandidat000332,Camilla Roede Skevik,2011,h,33,49,Vara,639,6,110776,35.7,Høyre,645,2011-09-12,3,3.02858739188349e-09,0,6,6
kandidat000333,Camilla Strandskog,2011,h,34,55,Vara,575,24,110776,35.7,Høyre,599,2011-09-12,37,1.44762734899271,4,41,37
kandidat000334,Camilla Wilhelmsen,2007,frp,14,14,Vara,338,18,38873,14.3,Fremskrittspartiet,356,2007-09-10,30,2.27401381963268,5,39,34
kandidat000335,Camilla Wilhelmsen,2011,frp,7,5,Vara,437,24,21852,7.04,Fremskrittspartiet,461,2011-09-12,170,12.2796029488211,22,209,187
kandidat000336,Camilla Wilhelmsen,2015,frp,2,2,Valgt,1146,169,19311,6.03,Fremskrittspartiet,1315,2015-09-14,699,44.1400400605446,131,908,777
kandidat000337,Carina Vestli Jørgensen,2011,ap,60,57,Ikke valgt,378,5,102707,33.1,Det norske Arbeiderparti,383,2011-09-12,10,0.0108898556517752,0,12,12
kandidat000338,Carina Westberg,2007,mdg,44,42,Ikke valgt,8,0,1687,0.62,Miljøpartiet De Grønne,8,2007-09-10,15,0.0731102843700785,0,16,16
kandidat000339,Carl Christian Blich,2007,h,13,17,Valgt,1536,47,68475,25.19,Høyre,1583,2007-09-10,464,0.868872435133276,2,626,624
kandidat000340,Carl Christian Blich,2011,h,12,17,Valgt,1766,60,110776,35.7,Høyre,1826,2011-09-12,150,4.69245000570516,9,776,767
kandidat000341,Carl-Henrik Bastiansen,2011,h,20,15,Valgt,868,62,110776,35.7,Høyre,930,2011-09-12,19,0.955879222770349,1,29,28
kandidat000342,Carl-Henrik Bastiansen,2015,h,31,21,Vara,631,31,101882,31.8,Høyre,662,2015-09-14,32,0.843775311795232,2,61,59
kandidat000343,Carl I Hagen,2015,frp,1,1,Valgt,5463,360,19311,6.03,Fremskrittspartiet,5823,NA,0,0,0,0,0
kandidat000344,Carl I. Hagen,2011,frp,1,1,Valgt,5125,293,21852,7.04,Fremskrittspartiet,5418,2011-09-12,25277,1928.66661477717,3747,78594,74847
kandidat000345,Carl-Magnus Fossum,2011,mdg,53,41,Ikke valgt,28,1,7653,2.47,Miljøpartiet De Grønne,29,2011-09-12,9,0.066479488088252,0,14,14
kandidat000346,Carl Morten Amundsen,2015,sv,44,18,Ikke valgt,112,17,17445,5.44,Sosialistisk Venstreparti,129,2015-09-14,284,2.73526400279509,6,1604,1598
kandidat000347,Carl Oscar Pedersen,2015,h,21,26,Vara,937,67,101882,31.8,Høyre,1004,2015-09-14,192,2.7105205989866,7,569,562
kandidat000348,Carlos Romeo Rodriguez,2007,rv,32,47,Ikke valgt,87,7,14131,5.2,Rød Valgallianse,94,NA,0,0,0,0,0
kandidat000349,Carl Philip Rasmussen,2007,kp,26,32,Ikke valgt,1,1,120000,0.04,Kystpartiet,2,NA,0,0,0,0,0
kandidat000350,Carmen Todsen,2007,mdg,45,50,Ikke valgt,6,2,1687,0.62,Miljøpartiet De Grønne,8,NA,0,0,0,0,0
kandidat000351,Carsten Mathisen,2007,pp,16,5,Ikke valgt,11,0,1414,0.52,Pensjonistpartiet,11,2007-09-10,4,0.0514694472911566,0,5,5
kandidat000352,Carsten Mathisen,2011,pp,9,9,Ikke valgt,15,5,1045,0.34,Pensjonistpartiet,20,2011-09-12,4,1.71167439065735e-06,0,9,9
kandidat000353,Cathrine Linn Kristiansen,2015,fi,1,1,Ikke valgt,292,568,1388,0.43,Feministisk Initiativ,860,2015-09-14,170,23.6181089847727,32,172,140
kandidat000354,Cato Schiøtz,2007,v,14,55,Ikke valgt,403,46,23703,8.72,Venstre,449,2007-09-10,1993,195.077670946176,447,5747,5300
kandidat000355,Cecilie Brein,2007,frp,13,17,Vara,341,26,38873,14.3,Fremskrittspartiet,367,2007-09-10,7,4.41295896712002,5,14,9
kandidat000356,Cecilie Brein,2011,frp,8,7,Vara,417,42,21852,7.04,Fremskrittspartiet,459,2011-09-12,502,35.2123535342169,211,516,305
kandidat000357,Cecilie Brein-Karlsen,2015,frp,21,21,Ikke valgt,178,20,19311,6.03,Fremskrittspartiet,198,2015-09-14,1039,17.4704178664425,50,1039,989
kandidat000358,Cecilie Flaatin,2011,mdg,4,4,Vara,260,50,7653,2.47,Miljøpartiet De Grønne,310,2011-09-12,2,1.16684018109515,2,6,4
kandidat000359,Cecilie Fosse,2015,frp,24,18,Ikke valgt,147,11,19311,6.03,Fremskrittspartiet,158,2015-09-14,7,0.000220857243656878,0,25,25
kandidat000360,Cecilie Gustafson,2011,frp,44,21,Ikke valgt,71,5,21852,7.04,Fremskrittspartiet,76,NA,0,0,0,0,0
kandidat000361,Celia Lima,2015,sv,4,5,Vara,1034,203,17445,5.44,Sosialistisk Venstreparti,1237,2015-09-14,3,0.000471778953938838,0,7,7
kandidat000362,C. F. Wesenberg,2011,mdg,41,25,Ikke valgt,34,5,7653,2.47,Miljøpartiet De Grønne,39,2011-09-12,65,0.481939993425465,1,131,130
kandidat000363,Channeh Joof Storvik,2011,ap,33,21,Vara,886,19,102707,33.1,Det norske Arbeiderparti,905,2011-09-12,11,1.05678950353105,1,14,13
kandidat000364,Channeh Maram Joof,2015,ap,43,44,Vara,972,20,102431,31.97,Arbeiderpartiet,992,2015-09-14,1,0,0,1,1
kandidat000365,Christel Gundelach,2011,frp,5,3,Vara,465,27,21852,7.04,Fremskrittspartiet,492,2011-09-12,42,4.57592746555052,10,55,45
kandidat000366,Christen Krogvig,2007,dem,8,54,Ikke valgt,9,2,306000,0.11,Demokratene,11,2007-09-10,17,0.356581332005883,1,28,27
kandidat000367,Christer Gulbrandsen,2007,sv,33,21,Ikke valgt,183,17,28701,10.56,Sosialistisk Venstreparti,200,2007-09-10,71,1.83786051029691,2,87,85
kandidat000368,Christer Kjølstad,2011,frp,41,43,Ikke valgt,83,6,21852,7.04,Fremskrittspartiet,89,2011-09-12,16,5.08980841048772,6,16,10
kandidat000369,Christian Børs Lind,2007,sv,46,25,Ikke valgt,130,7,28701,10.56,Sosialistisk Venstreparti,137,2007-09-10,11,0.250169124884724,1,108,107
kandidat000370,Christian Børs Lind,2011,sv,57,48,Ikke valgt,58,5,19477,6.28,Sosialistisk Venstreparti,63,2011-09-12,33,1.94209924098148,5,141,136
kandidat000371,Christian Dubrau,2015,mdg,52,40,Ikke valgt,117,17,26096,8.14,Miljøpartiet De Grønne,134,2015-09-14,3,0.0138703953002378,0,3,3
kandidat000372,Christian Grønlie Herzog,2015,v,9,10,Vara,306,180,21986,6.86,Venstre,486,2015-09-14,2,0.0219877471986388,0,2,2
kandidat000373,Christian Grorud,2011,mdg,7,5,Ikke valgt,165,25,7653,2.47,Miljøpartiet De Grønne,190,2011-09-12,16,0.000835060195687401,0,67,67
kandidat000374,Christian Hanseth,2011,kp,14,11,Ikke valgt,3,0,126000,0.04,Kystpartiet,3,2011-09-12,3,5.42133936735796e-08,0,3,3
kandidat000375,Christian Holmesland,2007,frp,31,29,Ikke valgt,168,4,38873,14.3,Fremskrittspartiet,172,2007-09-10,4,0.819564408734406,1,13,12
kandidat000376,Christian Johan Herzog,2011,v,13,11,Vara,316,69,25351,8.17,Venstre,385,2011-09-12,1,0.955041962190715,1,1,0
kandidat000377,Christian Lains,2015,pirat,14,11,Ikke valgt,25,1,805,0.25,Piratpartiet,26,NA,0,0,0,0,0
kandidat000378,Christian Von Reusch,2007,frp,44,44,Ikke valgt,116,3,38873,14.3,Fremskrittspartiet,119,2007-09-10,18,3.49896569411398e-07,0,18,18
kandidat000379,Christin W. Krohn,2007,h,6,6,Valgt,1741,42,68475,25.19,Høyre,1783,2007-09-10,1,0.91210514954509,1,2,1
kandidat000380,Christoffer Sahl,2007,krf,13,13,Ikke valgt,88,13,8368,3.08,Kristelig Folkeparti,101,2007-09-10,18,3.88465768153361,6,18,12
kandidat000381,Christoffer Sahl,2011,krf,42,47,Ikke valgt,48,3,7571,2.44,Kristelig Folkeparti,51,2011-09-12,41,0.0611199980161678,0,59,59
kandidat000382,Christoffer S. Jacobsen,2011,dem,9,24,Ikke valgt,5,3,214000,0.07,Demokratene i Norge,8,2011-09-12,1,0.0893673389217532,0,2,2
kandidat000383,Christoffer Torris Olsen,2007,v,56,49,Ikke valgt,102,8,23703,8.72,Venstre,110,2007-09-10,1,0.776467881823738,1,2,1
kandidat000384,Christopher Knoph,2011,ksp,5,5,Ikke valgt,13,4,235000,0.08,Kristent Samlingsparti,17,2011-09-12,1,1.06895415361435e-08,0,1,1
kandidat000385,Cihan Karakoc,2015,sv,18,22,Ikke valgt,297,76,17445,5.44,Sosialistisk Venstreparti,373,2015-09-14,2,1.97720592396627e-09,0,3,3
kandidat000386,Claes Arvidsson,2015,h,65,61,Ikke valgt,232,8,101882,31.8,Høyre,240,2015-09-14,114,2.89739577161358,7,123,116
kandidat000387,Claudio Varas Rojas,2015,rv,35,17,Ikke valgt,137,14,16174,5.05,Rødt,151,NA,0,0,0,0,0
kandidat000388,Claus Jervell,2007,rv,36,53,Ikke valgt,64,18,14131,5.2,Rød Valgallianse,82,2007-09-10,103,0.0318148684298036,0,130,130
kandidat000389,Cung Thi Doan,2015,krf,37,27,Ikke valgt,47,4,7827,2.44,Kristelig Folkeparti,51,2015-09-14,1,2.0406448012268e-09,0,3,3
kandidat000390,Dag Bayegan-Harlem,2015,ap,44,15,Ikke valgt,850,77,102431,31.97,Arbeiderpartiet,927,2015-09-14,76,2.81949064159536,2,76,74
kandidat000391,Dagfinn Vårvik,2007,sp,33,51,Ikke valgt,10,4,2189,0.81,Senterpartiet,14,2007-09-10,72,2.22202177521635,10,848,838
kandidat000392,Dagfinn Vårvik,2011,sp,40,56,Ikke valgt,8,2,1591,0.51,Senterpartiet,10,2011-09-12,77,1.69458149589355,15,925,910
kandidat000393,Dag Hagen,2007,nkp,14,17,Ikke valgt,4,5,203000,0.07,Norges Kommunistiske Parti,9,2007-09-10,158,3.42578212328452,8,308,300
kandidat000394,Dag Hagen,2015,nkp,13,10,Ikke valgt,10,4,240,0.07,Norges Kommunistiske Parti,14,2015-09-14,343,3.56802552499845,11,723,712
kandidat000395,Dag Harlem Stenersen,2007,ap,46,37,Ikke valgt,407,46,81265,29.89,Det norske Arbeiderparti,453,2007-09-10,119,3.37432227410976,5,185,180
kandidat000396,Dag Harlem Stenersen,2011,ap,25,14,Vara,979,123,102707,33.1,Det norske Arbeiderparti,1102,2011-09-12,124,3.65897593334795,7,309,302
kandidat000397,Dagny Sandnes,2007,sfp,12,16,Ikke valgt,7,0,129000,0.05,Samfunnspartiet,7,2007-09-10,6,0.0217661688166827,0,10,10
kandidat000398,Dag Olav Hessen,2015,mdg,14,58,Ikke valgt,584,81,26096,8.14,Miljøpartiet De Grønne,665,2015-09-14,201,8.9437438612519,14,442,428
kandidat000399,Daniel Gemtessa,2007,rv,35,25,Ikke valgt,76,8,14131,5.2,Rød Valgallianse,84,2007-09-10,2,9.50903911022619e-07,0,5,5
kandidat000400,Daniel Heggelid Rugaas,2015,v,39,49,Ikke valgt,110,17,21986,6.86,Venstre,127,2015-09-14,89,1.43484604830145e-05,0,246,246
kandidat000401,Daniel Ingar Davidsen,2015,pirat,5,6,Ikke valgt,44,6,805,0.25,Piratpartiet,50,NA,0,0,0,0,0
kandidat000402,Daniel Stephanek,2015,sp,2,2,Ikke valgt,120,52,1926,0.6,Senterpartiet,172,2015-09-14,56,6.10343104224458,10,59,49
kandidat000403,Danish Khan,2007,in,6,5,Ikke valgt,31,41,329000,0.12,Innvandrerpartiet,72,2007-09-10,11,0.683578329133666,2,11,9
kandidat000404,Danny Ghazanfar Chaudhry,2007,sp,5,9,Ikke valgt,58,42,2189,0.81,Senterpartiet,100,2007-09-10,4,0.195458688187307,0,4,4
kandidat000405,Danny Ghazanfar Chaudhry,2011,sp,4,20,Ikke valgt,291,62,1591,0.51,Senterpartiet,353,2011-09-12,47,3.21532956266131,4,51,47
kandidat000406,Danny Ghazanfar Chaudhry,2015,sp,4,7,Ikke valgt,64,25,1926,0.6,Senterpartiet,89,2015-09-14,9,1.84543187620816,2,60,58
kandidat000407,David Hansen,2007,krf,2,2,Valgt,778,246,8368,3.08,Kristelig Folkeparti,1024,2007-09-10,661,52.3101691227335,112,1237,1125
kandidat000408,Demmelash Mengistu,2015,mdg,43,26,Ikke valgt,144,7,26096,8.14,Miljøpartiet De Grønne,151,2015-09-14,3,0.0228282194659579,0,3,3
kandidat000409,Didrik Beck,2015,ap,10,9,Valgt,1579,28,102431,31.97,Arbeiderpartiet,1607,2015-09-14,51,2.03218833559817,4,53,49
kandidat000410,Didrik Frydenlund,2011,dem,20,27,Ikke valgt,3,0,214000,0.07,Demokratene i Norge,3,NA,0,0,0,0,0
kandidat000411,Dilek Ayhan,2007,osby,2,2,Ikke valgt,124,116,1466,0.54,Oslo Byaksjon,240,2007-09-10,75,2.07016287645901,5,95,90
kandidat000412,Dordi Edvardsen,2007,sp,34,43,Ikke valgt,9,4,2189,0.81,Senterpartiet,13,2007-09-10,1,0.00492712315397501,0,1,1
kandidat000413,Dordi Edvardsen,2011,sp,45,27,Ikke valgt,8,0,1591,0.51,Senterpartiet,8,2011-09-12,4,0.00301846286119018,0,5,5
kandidat000414,Dorota Toporowska,2007,mdg,12,16,Ikke valgt,43,14,1687,0.62,Miljøpartiet De Grønne,57,NA,0,0,0,0,0
kandidat000415,Dorota Toporowska,2011,mdg,30,46,Ikke valgt,47,3,7653,2.47,Miljøpartiet De Grønne,50,NA,0,0,0,0,0
kandidat000416,Douglas Draper,2007,mdg,20,17,Ikke valgt,22,4,1687,0.62,Miljøpartiet De Grønne,26,2007-09-10,2,0.000271648936636196,0,15,15
kandidat000417,Ebba Wergeland,2015,rv,22,64,Ikke valgt,224,23,16174,5.05,Rødt,247,2015-09-14,225,0.474421312671003,1,1460,1459
kandidat000418,Eddie Christopher Thomas,2015,frp,30,30,Ikke valgt,110,14,19311,6.03,Fremskrittspartiet,124,NA,0,0,0,0,0
kandidat000419,Edel Margrete Placht,2011,pp,23,21,Ikke valgt,9,1,1045,0.34,Pensjonistpartiet,10,NA,0,0,0,0,0
kandidat000420,Edith Helene Hammari,2015,pp,23,17,Ikke valgt,6,2,1169,0.36,Pensjonistpartiet,8,2015-09-14,1,5.30787359385614e-14,0,2,2
kandidat000421,Edna Thomassen,2007,sv,32,29,Ikke valgt,193,8,28701,10.56,Sosialistisk Venstreparti,201,2007-09-10,2,0.175110747265667,1,2,1
kandidat000422,Edyta Stylo,2011,h,60,56,Ikke valgt,224,23,110776,35.7,Høyre,247,2011-09-12,61,2.86486447985962e-09,0,61,61
kandidat000423,Egil Heinert,2007,ap,53,43,Ikke valgt,258,14,81265,29.89,Det norske Arbeiderparti,272,2007-09-10,30,0.0880010876551414,0,31,31
kandidat000424,Eilert Sannes,2015,dem,4,2,Ikke valgt,57,6,740,0.23,Demokratene i Norge,63,2015-09-14,3,0.00492712315397501,0,5,5
kandidat000425,Eilev Hegstad,2011,krf,9,5,Ikke valgt,204,30,7571,2.44,Kristelig Folkeparti,234,2011-09-12,19,3.65450544710914,6,24,18
kandidat000426,Eilev Hegstad,2015,krf,30,18,Ikke valgt,88,10,7827,2.44,Kristelig Folkeparti,98,2015-09-14,100,0.766735268834365,1,124,123
kandidat000427,Einar Olaf Lonstad,2007,pp,1,1,Ikke valgt,147,56,1414,0.52,Pensjonistpartiet,203,2007-09-10,1,0.00159640668061225,0,1,1
kandidat000428,Einar Olaf Lonstad,2011,pp,1,1,Ikke valgt,104,57,1045,0.34,Pensjonistpartiet,161,2011-09-12,3,1.59419231913914,2,4,2
kandidat000429,Einar Olaf Lonstad,2015,pp,1,1,Ikke valgt,150,79,1169,0.36,Pensjonistpartiet,229,2015-09-14,6,4.70347028040408,6,10,4
kandidat000430,Einy Langmoen,2015,mdg,22,11,Ikke valgt,330,44,26096,8.14,Miljøpartiet De Grønne,374,2015-09-14,89,8.88550630623452,17,153,136
kandidat000431,Eirik Brunvatne Thommessen,2007,ap,9,5,Valgt,1537,28,81265,29.89,Det norske Arbeiderparti,1565,2007-09-10,32,2.59895490078895,4,32,28
kandidat000432,Eirik Kollerøy,2011,h,31,34,Vara,630,50,110776,35.7,Høyre,680,2011-09-12,34,0.917047766063375,1,43,42
kandidat000433,Eirik Lae Solberg,2007,h,9,8,Valgt,1368,41,68475,25.19,Høyre,1409,2007-09-10,387,9.27543171906424,16,460,444
kandidat000434,Eirik Lae Solberg,2011,h,6,6,Valgt,1916,40,110776,35.7,Høyre,1956,2011-09-12,545,16.6343674094368,29,1005,976
kandidat000435,Eirik Lae Solberg,2015,h,6,7,Valgt,1858,66,101882,31.8,Høyre,1924,2015-09-14,1767,70.5591863173044,125,2772,2647
kandidat000436,Eirik Nordby,2007,rv,37,21,Ikke valgt,72,8,14131,5.2,Rød Valgallianse,80,2007-09-10,5,0.00504207613677934,0,17,17
kandidat000437,Eirik Rudi Wærner,2011,v,63,64,Ikke valgt,46,0,25351,8.17,Venstre,46,NA,0,0,0,0,0
kandidat000438,Eirik Wærner,2007,v,60,59,Ikke valgt,87,5,23703,8.72,Venstre,92,2007-09-10,60,0.415973482534599,1,131,130
kandidat000439,Eivind Frode Labråten,2015,pp,7,13,Ikke valgt,22,2,1169,0.36,Pensjonistpartiet,24,2015-09-14,3,1.90252434832368,3,3,0
kandidat000440,Eivind Heløe,2007,h,16,32,Valgt,1153,35,68475,25.19,Høyre,1188,2007-09-10,8,0.0778498758276311,0,28,28
kandidat000441,Eivind Knudsen,2011,frp,16,12,Ikke valgt,204,13,21852,7.04,Fremskrittspartiet,217,2011-09-12,1814,62.0419865662709,138,1962,1824
kandidat000442,Eivind Nikolaysen,2007,v,46,47,Ikke valgt,138,5,23703,8.72,Venstre,143,2007-09-10,14,0.106757004386863,0,25,25
kandidat000443,Eivind Odd Haanes,2007,krf,51,39,Ikke valgt,23,2,8368,3.08,Kristelig Folkeparti,25,NA,0,0,0,0,0
kandidat000444,Eivind Odd Haanes,2015,krf,40,32,Ikke valgt,45,2,7827,2.44,Kristelig Folkeparti,47,2015-09-14,3,1.80348292255169,2,5,3
kandidat000445,Eivind Trædal,2015,mdg,5,10,Valgt,986,276,26096,8.14,Miljøpartiet De Grønne,1262,2015-09-14,955,29.3996100626727,56,3217,3161
kandidat000446,Eivin Sundal,2015,ap,64,49,Ikke valgt,406,26,102431,31.97,Arbeiderpartiet,432,2015-09-14,60,0.773486978252564,1,91,90
kandidat000447,Eivor Evenrud,2015,rv,2,3,Valgt,1021,299,16174,5.05,Rødt,1320,2015-09-14,194,3.99268251210031,6,194,188
kandidat000448,Eivor Oftestad,2015,krf,32,39,Ikke valgt,89,7,7827,2.44,Kristelig Folkeparti,96,2015-09-14,99,2.28356007862691,8,110,102
kandidat000449,Eldbjørg Holte,2015,rv,57,46,Ikke valgt,83,1,16174,5.05,Rødt,84,2015-09-14,5,2.23643074696325e-08,0,50,50
kandidat000450,Eldbjørg Irene Ness,2011,sp,54,46,Ikke valgt,4,1,1591,0.51,Senterpartiet,5,2011-09-12,4,0.05523862053552,0,4,4
kandidat000451,Eldbjørg Mosvold Larsen,2007,krf,42,42,Ikke valgt,25,5,8368,3.08,Kristelig Folkeparti,30,2007-09-10,2,1.31989634965932,2,3,1
kandidat000452,Eli Aaby,2011,rv,62,53,Ikke valgt,32,1,11257,3.63,Rødt,33,2011-09-12,42,5.51909928251983e-06,0,145,145
kandidat000453,Eline Solum Gran,2015,mdg,34,37,Ikke valgt,197,11,26096,8.14,Miljøpartiet De Grønne,208,2015-09-14,5,0.12349821299232,1,9,8
kandidat000454,Elin Horn Galtung,2015,h,12,14,Valgt,1855,105,101882,31.8,Høyre,1960,2015-09-14,123,0.0448917542057628,0,801,801
kandidat000455,Elin Østvik,2011,rv,6,7,Vara,291,56,11257,3.63,Rødt,347,2011-09-12,70,0.269196663500414,0,124,124
kandidat000456,Elin Volder Rutle,2011,rv,5,5,Vara,299,52,11257,3.63,Rødt,351,2011-09-12,170,5.8760083182459,9,184,175
kandidat000457,Elin Volder Rutle,2015,rv,37,37,Ikke valgt,142,8,16174,5.05,Rødt,150,2015-09-14,129,0.0452441435648823,0,313,313
kandidat000458,Elisabeth Braarud,2011,mdg,15,14,Ikke valgt,88,8,7653,2.47,Miljøpartiet De Grønne,96,2011-09-12,2,5.81785225454538e-05,0,2,2
kandidat000459,Elisabeth Idland,2011,frp,38,36,Ikke valgt,91,5,21852,7.04,Fremskrittspartiet,96,2011-09-12,21,0.00948379138343595,0,30,30
kandidat000460,Elisabeth Kristiansen,2015,fi,8,7,Ikke valgt,53,27,1388,0.43,Feministisk Initiativ,80,2015-09-14,365,10.8192431162095,22,835,813
kandidat000461,Elisabeth Løland,2015,krf,6,9,Ikke valgt,323,50,7827,2.44,Kristelig Folkeparti,373,2015-09-14,1613,5.57055079405472,12,1867,1855
kandidat000462,Elisabeth Rode Gustavsen,2015,rv,55,50,Ikke valgt,89,2,16174,5.05,Rødt,91,2015-09-14,1,0.071005353739637,0,1,1
kandidat000463,Elise Fylling,2015,sp,40,34,Ikke valgt,12,2,1926,0.6,Senterpartiet,14,2015-09-14,6,1.68893110967711e-07,0,8,8
kandidat000464,Elise Haugland,2015,krf,25,15,Ikke valgt,97,14,7827,2.44,Kristelig Folkeparti,111,2015-09-14,49,2.1370129446049,5,101,96
kandidat000465,Elizabeth D. C. Vicencio,2007,sfp,6,10,Ikke valgt,11,0,129000,0.05,Samfunnspartiet,11,NA,0,0,0,0,0
kandidat000466,Ellen-Elisabeth Akre-Aas,2015,pp,5,8,Ikke valgt,22,5,1169,0.36,Pensjonistpartiet,27,NA,0,0,0,0,0
kandidat000467,Ellen Gjelseth,2007,frp,27,32,Ikke valgt,190,7,38873,14.3,Fremskrittspartiet,197,2007-09-10,2,0.00552760860795841,0,3,3
kandidat000468,Ellen Johansen Ormberg,2015,nkp,1,1,Ikke valgt,30,32,240,0.07,Norges Kommunistiske Parti,62,2015-09-14,5,2.52153366768576,5,5,0
kandidat000469,Ellen Lerberg,2007,sv,51,51,Ikke valgt,114,7,28701,10.56,Sosialistisk Venstreparti,121,2007-09-10,45,1.06401280645614,1,77,76
kandidat000470,Ellen Lerberg,2011,sv,54,55,Ikke valgt,73,6,19477,6.28,Sosialistisk Venstreparti,79,2011-09-12,152,6.69248873296951,11,229,218
kandidat000471,Ellen Marie Andersen,2011,kp,13,5,Ikke valgt,3,0,126000,0.04,Kystpartiet,3,2011-09-12,189,0.133525312830138,1,304,303
kandidat000472,Ellen Marie Andersen,2015,sp,24,14,Ikke valgt,19,6,1926,0.6,Senterpartiet,25,2015-09-14,11,0.0619073028809276,0,315,315
kandidat000473,Ellen Røsjø,2007,rv,18,12,Ikke valgt,188,13,14131,5.2,Rød Valgallianse,201,2007-09-10,10,0.404584368235871,1,49,48
kandidat000474,Ellen Røsjø,2011,rv,40,36,Ikke valgt,60,10,11257,3.63,Rødt,70,2011-09-12,74,0.00626819425953034,0,123,123
kandidat000475,Ellen Simonsen,2015,dem,1,1,Ikke valgt,128,26,740,0.23,Demokratene i Norge,154,2015-09-14,37,4.9135005246872,11,269,258
kandidat000476,Ellen W. Ronæss,2007,h,42,49,Ikke valgt,298,13,68475,25.19,Høyre,311,2007-09-10,14,0.912116401476839,1,62,61
kandidat000477,Elling Borgersrud,2007,rv,20,41,Ikke valgt,165,19,14131,5.2,Rød Valgallianse,184,2007-09-10,148,6.58306933694606,12,238,226
kandidat000478,Elling Borgersrud,2011,rv,22,48,Ikke valgt,136,17,11257,3.63,Rødt,153,2011-09-12,296,6.85176998531397,23,534,511
kandidat000479,Elling Borgersrud,2015,rv,18,41,Ikke valgt,315,31,16174,5.05,Rødt,346,2015-09-14,139,2.53435315698415,4,673,669
kandidat000480,Elmar Løvli,2007,kp,44,27,Ikke valgt,0,0,120000,0.04,Kystpartiet,0,NA,0,0,0,0,0
kandidat000481,Elray Henriksen,2011,mdg,20,15,Ikke valgt,57,15,7653,2.47,Miljøpartiet De Grønne,72,2011-09-12,5,2.53387062029736,3,5,2
kandidat000482,Elsa Anette Børresen,2007,pp,15,19,Ikke valgt,11,1,1414,0.52,Pensjonistpartiet,12,NA,0,0,0,0,0
kandidat000483,Elsa-Britt Enger,2011,mdg,32,30,Ikke valgt,42,6,7653,2.47,Miljøpartiet De Grønne,48,2011-09-12,3,0.00934610077307671,0,6,6
kandidat000484,Elsa-Britt Enger,2015,mdg,48,35,Ikke valgt,134,6,26096,8.14,Miljøpartiet De Grønne,140,2015-09-14,15,3.38423467650569,4,21,17
kandidat000485,Else Leona McClimans,2015,v,42,45,Ikke valgt,116,8,21986,6.86,Venstre,124,2015-09-14,40,0.00474841483265092,0,71,71
kandidat000486,Elvis Chi Nwosu,2007,ap,23,39,Vara,861,126,81265,29.89,Det norske Arbeiderparti,987,2007-09-10,335,15.3086281300389,13,355,342
kandidat000487,Elvis Chi Nwosu,2011,ap,17,16,Valgt,1732,115,102707,33.1,Det norske Arbeiderparti,1847,2011-09-12,386,4.03190209599185,9,741,732
kandidat000488,Elvis Chi Nwosu,2015,ap,34,39,Vara,1319,79,102431,31.97,Arbeiderpartiet,1398,2015-09-14,307,8.7511910704027,16,1048,1032
kandidat000489,Elzbieta Toporowska,2007,mdg,28,54,Ikke valgt,17,2,1687,0.62,Miljøpartiet De Grønne,19,NA,0,0,0,0,0
kandidat000490,Emil André Erstad,2015,krf,10,28,Ikke valgt,179,22,7827,2.44,Kristelig Folkeparti,201,2015-09-14,1237,30.0394987336265,63,1386,1323
kandidat000491,Emma Løvaas Akyeampong,2015,krf,19,7,Ikke valgt,104,29,7827,2.44,Kristelig Folkeparti,133,2015-09-14,6,0.390987149151598,1,8,7
kandidat000492,Emma Staffansdotter Langmoen,2015,mdg,23,15,Ikke valgt,342,23,26096,8.14,Miljøpartiet De Grønne,365,2015-09-14,4,9.41401911455473e-13,0,4,4
kandidat000493,Erik Borge Skei,2015,v,7,8,Vara,459,171,21986,6.86,Venstre,630,2015-09-14,69,1.84450555025058,2,107,105
kandidat000494,Erik Dugstad,2011,ap,51,48,Ikke valgt,456,32,102707,33.1,Det norske Arbeiderparti,488,2011-09-12,20,1.01714250066107,1,61,60
kandidat000495,Erik Gjertsen,2015,kp,7,7,Ikke valgt,7,1,124,0.04,Kystpartiet,8,2015-09-14,54,0.181974018675453,1,127,126
kandidat000496,Erik Hagen,2007,rv,56,43,Ikke valgt,35,0,14131,5.2,Rød Valgallianse,35,2007-09-10,35574,2138.91526668218,4937,46514,41577
kandidat000497,Erik Lahnstein,2007,sp,4,5,Ikke valgt,117,53,2189,0.81,Senterpartiet,170,2007-09-10,981,110.990674724499,183,1103,920
kandidat000498,Erik Lahnstein,2011,sp,1,2,Ikke valgt,118,111,1591,0.51,Senterpartiet,229,2011-09-12,6064,170.482790716221,334,7167,6833
kandidat000499,Erik Lunde,2007,krf,28,44,Ikke valgt,54,2,8368,3.08,Kristelig Folkeparti,56,2007-09-10,567,40.4147976713679,108,1048,940
kandidat000500,Erik Lunde,2011,krf,2,2,Vara,631,246,7571,2.44,Kristelig Folkeparti,877,2011-09-12,991,33.5122861655158,67,2039,1972
kandidat000501,Erik Lunde,2015,krf,1,1,Valgt,1557,891,7827,2.44,Kristelig Folkeparti,2448,2015-09-14,2530,137.832797100753,242,4569,4327
kandidat000502,Erik Lundesgaard,2011,h,52,38,Ikke valgt,317,37,110776,35.7,Høyre,354,2011-09-12,214,11.767339544904,22,327,305
kandidat000503,Erik Ravnsborg Gjertsen,2007,kp,14,17,Ikke valgt,1,2,120000,0.04,Kystpartiet,3,NA,0,0,0,0,0
kandidat000504,Erik Ravnsborg Gjertsen,2011,kp,9,10,Ikke valgt,3,1,126000,0.04,Kystpartiet,4,2011-09-12,1,6.06188686772547e-12,0,2,2
kandidat000505,Erik Schjenken,2015,frp,7,23,Vara,374,33,19311,6.03,Fremskrittspartiet,407,2015-09-14,1179,5.55692678159835,12,3038,3026
kandidat000506,Erik Soltvedt Wilvang,2007,h,59,62,Ikke valgt,184,1,68475,25.19,Høyre,185,NA,0,0,0,0,0
kandidat000507,Erlend Loe,2015,mdg,11,64,Vara,1450,120,26096,8.14,Miljøpartiet De Grønne,1570,2015-09-14,3473,106.753781568093,206,13445,13239
kandidat000508,Erling Dokk Holm,2007,osby,11,11,Ikke valgt,128,121,1466,0.54,Oslo Byaksjon,249,2007-09-10,502,16.2801633940377,29,772,743
kandidat000509,Erling Dokk Holm,2015,mdg,16,56,Ikke valgt,496,64,26096,8.14,Miljøpartiet De Grønne,560,2015-09-14,1975,33.0256412047696,77,4089,4012
kandidat000510,Erling Folkvord,2007,rv,1,1,Valgt,4497,3758,14131,5.2,Rød Valgallianse,8255,2007-09-10,1737,362.697810342248,513,5830,5317
kandidat000511,Erling Folkvord,2011,rv,11,55,Ikke valgt,750,250,11257,3.63,Rødt,1000,2011-09-12,3483,64.0637852350276,214,9313,9099
kandidat000512,Erling Folkvord,2015,rv,12,38,Ikke valgt,650,148,16174,5.05,Rødt,798,2015-09-14,1131,40.3997587365344,126,10444,10318
kandidat000513,Erling Fossen,2007,osby,1,1,Ikke valgt,388,759,1466,0.54,Oslo Byaksjon,1147,2007-09-10,887,25.2474979514248,43,1626,1583
kandidat000514,Erling Kvalheim,2011,frp,46,33,Ikke valgt,68,6,21852,7.04,Fremskrittspartiet,74,2011-09-12,6,0.0114089989894289,0,19,19
kandidat000515,Erling Kylstad,2007,sp,42,31,Ikke valgt,8,0,2189,0.81,Senterpartiet,8,2007-09-10,5,0.00558011579760238,0,12,12
kandidat000516,Erling Kylstad,2011,sp,47,38,Ikke valgt,6,2,1591,0.51,Senterpartiet,8,2011-09-12,4,0.00751251724181476,0,16,16
kandidat000517,Erling Kylstad,2015,sp,44,27,Ikke valgt,12,0,1926,0.6,Senterpartiet,12,2015-09-14,2,2.31851172665717e-05,0,18,18
kandidat000518,Erling Lae,2007,h,1,1,Valgt,19646,3645,68475,25.19,Høyre,23291,2007-09-10,9131,1316.00059751421,2288,12484,10196
kandidat000519,Erling Lægreid,2007,sfp,2,8,Ikke valgt,10,18,129000,0.05,Samfunnspartiet,28,2007-09-10,197,3.79299380725832,8,582,574
kandidat000520,Erling Melenius,2007,pp,11,6,Ikke valgt,14,0,1414,0.52,Pensjonistpartiet,14,NA,0,0,0,0,0
kandidat000521,Erling Melenius,2011,pp,17,6,Ikke valgt,12,2,1045,0.34,Pensjonistpartiet,14,2011-09-12,3,1.20501206070205e-08,0,5,5
kandidat000522,Erling Melenius,2015,pp,9,5,Ikke valgt,19,3,1169,0.36,Pensjonistpartiet,22,NA,0,0,0,0,0
kandidat000523,Erling O Turtum,2015,ap,56,37,Ikke valgt,634,11,102431,31.97,Arbeiderpartiet,645,2015-09-14,21,0.0475671643428955,0,21,21
kandidat000524,Erling Unnli,2011,pp,29,28,Ikke valgt,8,0,1045,0.34,Pensjonistpartiet,8,NA,0,0,0,0,0
kandidat000525,Erna Kahlbom,2015,sv,45,41,Ikke valgt,116,8,17445,5.44,Sosialistisk Venstreparti,124,2015-09-14,4,4.5652496757778e-09,0,70,70
kandidat000526,Ernst Laine,2007,pp,33,25,Ikke valgt,4,0,1414,0.52,Pensjonistpartiet,4,NA,0,0,0,0,0
kandidat000527,Ernst Laine,2011,pp,14,15,Ikke valgt,15,0,1045,0.34,Pensjonistpartiet,15,NA,0,0,0,0,0
kandidat000528,Eskil Pedersen,2007,ap,38,53,Vara,568,21,81265,29.89,Det norske Arbeiderparti,589,2007-09-10,593,13.0625096666152,13,622,609
kandidat000529,Eskil Pedersen,2015,ap,23,64,Vara,2251,109,102431,31.97,Arbeiderpartiet,2360,2015-09-14,21880,108.614325773592,307,27256,26949
kandidat000530,Esmaeil Akbari,2007,sv,16,17,Ikke valgt,573,50,28701,10.56,Sosialistisk Venstreparti,623,2007-09-10,1,1.68893077459974e-07,0,7,7
kandidat000531,Esmaeil Akbari Ghannad,2011,sv,25,12,Ikke valgt,196,20,19477,6.28,Sosialistisk Venstreparti,216,2011-09-12,1,0.977262483773277,1,1,0
kandidat000532,Espen Andreas Hasle,2015,krf,5,10,Vara,338,36,7827,2.44,Kristelig Folkeparti,374,2015-09-14,167,0.560111000618755,1,343,342
kandidat000533,Espen Langvik,2015,v,20,16,Ikke valgt,208,35,21986,6.86,Venstre,243,2015-09-14,570,37.8342476034953,91,1079,988
kandidat000534,Espen Ophaug,2007,v,40,50,Ikke valgt,121,50,23703,8.72,Venstre,171,2007-09-10,32,1.01853964991892,1,55,54
kandidat000535,Espen Ophaug,2011,v,6,5,Vara,465,161,25351,8.17,Venstre,626,2011-09-12,77,7.18743502566239,12,132,120
kandidat000536,Espen Ophaug,2015,v,3,4,Valgt,764,145,21986,6.86,Venstre,909,2015-09-14,526,26.6744958342276,64,658,594
kandidat000537,Eugen Johan Ellertsen,2007,pp,34,31,Ikke valgt,3,1,1414,0.52,Pensjonistpartiet,4,NA,0,0,0,0,0
kandidat000538,Eva Celine Jørgensen,2015,rv,39,26,Ikke valgt,123,4,16174,5.05,Rødt,127,2015-09-14,7,0.00176312485456551,0,11,11
kandidat000539,Eva Hajnal Nyhamn,2007,mdg,16,12,Ikke valgt,28,2,1687,0.62,Miljøpartiet De Grønne,30,NA,0,0,0,0,0
kandidat000540,Eva Meisfjord,2007,nkp,17,19,Ikke valgt,6,2,203000,0.07,Norges Kommunistiske Parti,8,NA,0,0,0,0,0
kandidat000541,Eva Michelsen Ekroll,2015,v,37,28,Ikke valgt,136,2,21986,6.86,Venstre,138,2015-09-14,64,0.101174943811209,0,66,66
kandidat000542,Even Birkedal,2007,dem,27,26,Ikke valgt,1,1,306000,0.11,Demokratene,2,2007-09-10,7,0.0239542560994235,0,8,8
kandidat000543,Even Westerveld,2007,krf,35,59,Ikke valgt,31,3,8368,3.08,Kristelig Folkeparti,34,2007-09-10,227,12.9949346575939,20,228,208
kandidat000544,Ewa Gawecka,2015,h,33,31,Vara,611,21,101882,31.8,Høyre,632,2015-09-14,13,0.181599707048385,1,36,35
kandidat000545,Ewa Thim,2007,frp,42,48,Ikke valgt,134,0,38873,14.3,Fremskrittspartiet,134,2007-09-10,3,0.0957735455955022,0,3,3
kandidat000546,Eyvind Skeie,2007,v,34,56,Ikke valgt,180,13,23703,8.72,Venstre,193,2007-09-10,302,16.0197547024966,28,756,728
kandidat000547,Fabian Stang,2007,h,2,2,Valgt,7330,674,68475,25.19,Høyre,8004,2007-09-10,2301,1018.75333895988,1486,2608,1122
kandidat000548,Fabian Stang,2011,h,1,1,Valgt,43729,9778,110776,35.7,Høyre,53507,2011-09-12,14922,1187.67021892862,2075,17530,15455
kandidat000549,Fabian Stang,2015,h,1,1,Valgt,40542,3373,101882,31.8,Høyre,43915,2015-09-14,19110,643.108956283961,1039,36640,35601
kandidat000550,Fahila Nawaz,2007,rv,23,33,Ikke valgt,138,11,14131,5.2,Rød Valgallianse,149,2007-09-10,1,1.05278183024543e-11,0,1,1
kandidat000551,Fahila Nawaz,2015,rv,48,39,Ikke valgt,104,5,16174,5.05,Rødt,109,2015-09-14,1,1.47122538820305e-07,0,3,3
kandidat000552,Faisal Butt Akram,2007,sfp,4,2,Ikke valgt,14,12,129000,0.05,Samfunnspartiet,26,NA,0,0,0,0,0
kandidat000553,Farah Ramadan,2011,sv,23,53,Ikke valgt,197,23,19477,6.28,Sosialistisk Venstreparti,220,2011-09-12,3,1.07159940200513,1,3,2
kandidat000554,Fatima Ali Madar,2011,ap,19,47,Valgt,1584,44,102707,33.1,Det norske Arbeiderparti,1628,2011-09-12,11,4.39958503735947,6,12,6
kandidat000555,Fatima Ali Madar,2015,ap,25,40,Vara,1767,39,102431,31.97,Arbeiderpartiet,1806,2015-09-14,78,0.529814900628532,3,90,87
kandidat000556,Fatma Süslü,2007,osby,19,29,Ikke valgt,20,10,1466,0.54,Oslo Byaksjon,30,NA,0,0,0,0,0
kandidat000557,Fatmata Kanu,2007,mdg,17,30,Ikke valgt,22,6,1687,0.62,Miljøpartiet De Grønne,28,NA,0,0,0,0,0
kandidat000558,Finn Dyrkorn,2015,mdg,62,42,Ikke valgt,73,7,26096,8.14,Miljøpartiet De Grønne,80,2015-09-14,16,4.17263252067128,6,42,36
kandidat000559,Francis K Acquah,2015,ksp,2,2,Ikke valgt,57,12,421,0.13,Partiet De Kristne,69,2015-09-14,2,5.74786179844818e-08,0,2,2
kandidat000560,Francis Rønnestad,2015,krf,57,48,Ikke valgt,20,0,7827,2.44,Kristelig Folkeparti,20,2015-09-14,37,0.675073799203279,3,38,35
kandidat000561,Frank Eugen Edvardsen,2007,dem,17,16,Ikke valgt,2,2,306000,0.11,Demokratene,4,NA,0,0,0,0,0
kandidat000562,Freddy Wahl Stensby,2015,ksp,11,17,Ikke valgt,12,1,421,0.13,Partiet De Kristne,13,NA,0,0,0,0,0
kandidat000563,Fredrick Otieno Makosir,2007,krf,45,46,Ikke valgt,25,3,8368,3.08,Kristelig Folkeparti,28,NA,0,0,0,0,0
kandidat000564,Fredrick Otieno Makosir,2011,krf,47,43,Ikke valgt,37,2,7571,2.44,Kristelig Folkeparti,39,2011-09-12,17,8.13863605647254e-07,0,17,17
kandidat000565,Fredrick Otieno Makosir,2015,krf,51,42,Ikke valgt,26,1,7827,2.44,Kristelig Folkeparti,27,2015-09-14,1,1.33534715856642e-14,0,18,18
kandidat000566,Fredrik Arentz,2007,mdg,40,59,Ikke valgt,4,5,1687,0.62,Miljøpartiet De Grønne,9,2007-09-10,24,0.856443765587399,2,42,40
kandidat000567,Fredrik Arentz,2015,mdg,65,46,Ikke valgt,65,2,26096,8.14,Miljøpartiet De Grønne,67,2015-09-14,23,0.0593708548377476,0,75,75
kandidat000568,Fredrik Jomark,2015,lib,4,4,Ikke valgt,40,8,458,0.14,Liberalistene Oslo,48,NA,0,0,0,0,0
kandidat000569,Fredrik Juel Hagen,2011,frp,24,35,Ikke valgt,123,6,21852,7.04,Fremskrittspartiet,129,2011-09-12,6,0.59775091717742,1,6,5
kandidat000570,Fredrik Mellem,2007,ap,31,19,Vara,683,48,81265,29.89,Det norske Arbeiderparti,731,2007-09-10,73,7.19118679793111,14,92,78
kandidat000571,Fredrik Mellem,2011,ap,30,18,Vara,984,32,102707,33.1,Det norske Arbeiderparti,1016,2011-09-12,262,4.64691338505266,9,354,345
kandidat000572,Fredrik Meyer,2011,dlf,4,4,Ikke valgt,15,2,247000,0.08,Det Liberale Folkepartiet,17,2011-09-12,111,3.09539720929508,8,345,337
kandidat000573,Fredrik Olstad,2015,rv,54,24,Ikke valgt,84,7,16174,5.05,Rødt,91,2015-09-14,22,4.61783161904308,10,37,27
kandidat000574,Fredrik Røe Brevig,2011,nkp,5,3,Ikke valgt,15,6,210000,0.07,Norges Kommunistiske Parti,21,2011-09-12,58,3.28748848749461e-06,0,60,60
kandidat000575,Fredrik Røe Brevig,2015,nkp,12,6,Ikke valgt,13,3,240,0.07,Norges Kommunistiske Parti,16,NA,0,0,0,0,0
kandidat000576,Fredrik Semcesen,2011,dem,26,25,Ikke valgt,2,0,214000,0.07,Demokratene i Norge,2,2011-09-12,2,1.55293576364748,2,2,0
kandidat000577,Fredrik S. Heffermehl,2011,mdg,47,55,Ikke valgt,33,4,7653,2.47,Miljøpartiet De Grønne,37,2011-09-12,812,0.323340004721039,0,1488,1488
kandidat000578,Fredrik Smith,2011,dem,17,26,Ikke valgt,4,1,214000,0.07,Demokratene i Norge,5,2011-09-12,38,1.35467008195803,4,72,68
kandidat000579,Fredrik Winther,2007,osby,6,4,Ikke valgt,59,37,1466,0.54,Oslo Byaksjon,96,2007-09-10,25,4.74102611009291,9,31,22
kandidat000580,Frida Blomgren,2007,v,37,27,Ikke valgt,176,7,23703,8.72,Venstre,183,2007-09-10,1,1.2524425077888e-07,0,2,2
kandidat000581,Frida Blomgren,2015,v,21,25,Ikke valgt,204,14,21986,6.86,Venstre,218,2015-09-14,26,0.0207454828377505,0,297,297
kandidat000582,Frithjof Eide Fjeldstad,2015,fi,5,4,Ikke valgt,64,56,1388,0.43,Feministisk Initiativ,120,2015-09-14,13,0.0859055968280406,0,182,182
kandidat000583,Fritz Roar Børnes,2007,sfp,14,11,Ikke valgt,6,0,129000,0.05,Samfunnspartiet,6,NA,0,0,0,0,0
kandidat000584,Frode Ersfjord,2015,sv,40,12,Ikke valgt,135,19,17445,5.44,Sosialistisk Venstreparti,154,2015-09-14,158,2.92823806749338,9,162,153
kandidat000585,Frode Fjeldstad,2007,v,44,31,Ikke valgt,152,3,23703,8.72,Venstre,155,2007-09-10,30,3.36141665362273,7,45,38
kandidat000586,Frode Jacobsen,2015,ap,6,4,Valgt,2614,87,102431,31.97,Arbeiderpartiet,2701,2015-09-14,1358,64.7630324478519,110,4945,4835
kandidat000587,Frode Kyvåg,2015,ap,12,17,Valgt,4229,261,102431,31.97,Arbeiderpartiet,4490,2015-09-14,2552,142.775463898091,344,9769,9425
kandidat000588,Frode Woldsund,2007,krf,10,15,Ikke valgt,103,33,8368,3.08,Kristelig Folkeparti,136,2007-09-10,64,4.34238647334323,7,88,81
kandidat000589,Frode Woldsund,2011,krf,19,13,Ikke valgt,111,20,7571,2.44,Kristelig Folkeparti,131,2011-09-12,226,4.35818813620689,10,314,304
kandidat000590,Frode Woldsund,2015,krf,8,4,Ikke valgt,194,58,7827,2.44,Kristelig Folkeparti,252,2015-09-14,254,6.13461691627968,12,568,556
kandidat000591,Frøydis Strømme Jørve,2015,mdg,44,49,Ikke valgt,145,5,26096,8.14,Miljøpartiet De Grønne,150,2015-09-14,1,0.000130126955927367,0,1,1
kandidat000592,Gabrielle Legrand Gjerdset,2015,sv,14,21,Ikke valgt,374,109,17445,5.44,Sosialistisk Venstreparti,483,2015-09-14,154,0.000769516895240266,0,165,165
kandidat000593,Gard Lindseth,2007,v,55,46,Ikke valgt,106,5,23703,8.72,Venstre,111,2007-09-10,61,1.4031973122447,3,78,75
kandidat000594,Gard Sandaker-Nielsen,2015,ap,61,59,Ikke valgt,487,41,102431,31.97,Arbeiderpartiet,528,2015-09-14,178,5.64580364609755,10,336,326
kandidat000595,Gaute Brækken,2011,krf,13,7,Ikke valgt,119,40,7571,2.44,Kristelig Folkeparti,159,2011-09-12,63,1.95885710767537,3,70,67
kandidat000596,Gaute Brækken,2015,krf,9,6,Ikke valgt,142,65,7827,2.44,Kristelig Folkeparti,207,2015-09-14,74,3.02514236235204,4,144,140
kandidat000597,Geeta Joshi,2007,in,8,3,Ikke valgt,41,24,329000,0.12,Innvandrerpartiet,65,NA,0,0,0,0,0
kandidat000598,Geir Isene,2015,pirat,16,9,Ikke valgt,19,6,805,0.25,Piratpartiet,25,2015-09-14,48,0.0141585584511425,0,223,223
kandidat000599,Geir Kvarme,2015,h,13,15,Valgt,1675,115,101882,31.8,Høyre,1790,2015-09-14,712,13.5081908916435,45,2083,2038
kandidat000600,Geir Lahnstein,2007,sp,15,33,Ikke valgt,29,4,2189,0.81,Senterpartiet,33,2007-09-10,8,0.917365033619505,1,60,59
kandidat000601,Geir Lahnstein,2011,sp,24,39,Ikke valgt,9,6,1591,0.51,Senterpartiet,15,2011-09-12,31,1.3410351122581,3,91,88
kandidat000602,Geir Lippestad,2015,ap,11,33,Valgt,6947,523,102431,31.97,Arbeiderpartiet,7470,2015-09-14,26952,122.189424222632,232,32146,31914
kandidat000603,Geirmund Jor,2011,sv,42,32,Ikke valgt,108,12,19477,6.28,Sosialistisk Venstreparti,120,2011-09-12,352,9.85032502751281,13,462,449
kandidat000604,Geirmund Jor,2015,sv,50,44,Ikke valgt,79,9,17445,5.44,Sosialistisk Venstreparti,88,2015-09-14,220,4.8795901942762,7,682,675
kandidat000605,Geir Olav Tungland,2015,ksp,1,1,Ikke valgt,84,31,421,0.13,Partiet De Kristne,115,2015-09-14,7,2.93383244782679,5,7,2
kandidat000606,Geir Storli Jensen,2015,mdg,45,30,Ikke valgt,125,24,26096,8.14,Miljøpartiet De Grønne,149,2015-09-14,8,3.32045726975923e-07,0,10,10
kandidat000607,Geo von Krogh,2007,sfp,7,7,Ikke valgt,8,2,129000,0.05,Samfunnspartiet,10,2007-09-10,2,0.409076614306046,2,50,48
kandidat000608,Gerd Kvanvig,2011,ap,63,55,Ikke valgt,277,6,102707,33.1,Det norske Arbeiderparti,283,2011-09-12,16,0.00110511228804104,0,34,34
kandidat000609,Gerhard Berg,2007,krf,31,21,Ikke valgt,40,5,8368,3.08,Kristelig Folkeparti,45,2007-09-10,36,2.96394701899946,8,456,448
kandidat000610,Gina Maria Grønlien Østmoe,2011,sp,57,54,Ikke valgt,4,0,1591,0.51,Senterpartiet,4,2011-09-12,5,0.00329940160991622,0,15,15
kandidat000611,Gisle Hannemyr,2007,osby,15,46,Ikke valgt,24,16,1466,0.54,Oslo Byaksjon,40,2007-09-10,862,26.9405997078918,69,1306,1237
kandidat000612,Gjermund Løyning,2007,krf,8,11,Ikke valgt,127,21,8368,3.08,Kristelig Folkeparti,148,2007-09-10,117,0.191437091814049,1,191,190
kandidat000613,Glenn Steffensen,2015,dem,5,4,Ikke valgt,52,4,740,0.23,Demokratene i Norge,56,NA,0,0,0,0,0
kandidat000614,Gøril Bjerkhol Havro,2011,v,20,14,Ikke valgt,231,15,25351,8.17,Venstre,246,2011-09-12,3,0.794491782676423,2,3,1
kandidat000615,Gøril Bjerkhol Havro,2015,v,16,13,Ikke valgt,257,18,21986,6.86,Venstre,275,2015-09-14,2,2.36780133299369e-11,0,5,5
kandidat000616,Gørild Beatrice Bendixen,2011,mdg,37,28,Ikke valgt,36,7,7653,2.47,Miljøpartiet De Grønne,43,2011-09-12,2,2.73917762509762e-06,0,3,3
kandidat000617,Grete Haugdal,2011,ap,35,19,Vara,818,13,102707,33.1,Det norske Arbeiderparti,831,2011-09-12,12,1.28424944714874,3,18,15
kandidat000618,Grete Horntvedt,2007,h,23,35,Vara,637,24,68475,25.19,Høyre,661,2007-09-10,1963,14.4851883494017,28,4668,4640
kandidat000619,Grete Horntvedt,2015,h,18,12,Valgt,1085,53,101882,31.8,Høyre,1138,2015-09-14,170,4.66853618855631,8,5107,5099
kandidat000620,Grete Sofie Fallan Glasø-Olsen,2015,pirat,13,18,Ikke valgt,21,6,805,0.25,Piratpartiet,27,NA,0,0,0,0,0
kandidat000621,Grethe Helgesen,2007,kp,35,20,Ikke valgt,1,0,120000,0.04,Kystpartiet,1,NA,0,0,0,0,0
kandidat000622,Grethe Horn,2015,pp,12,23,Ikke valgt,16,4,1169,0.36,Pensjonistpartiet,20,2015-09-14,19,0.468175751573569,1,99,98
kandidat000623,Grethe Østhell,2007,frp,45,49,Ikke valgt,113,1,38873,14.3,Fremskrittspartiet,114,2007-09-10,3,0.000139862212086247,0,3,3
kandidat000624,Grethe Østhell,2011,frp,50,42,Ikke valgt,66,2,21852,7.04,Fremskrittspartiet,68,2011-09-12,8,0.625486875906213,1,11,10
kandidat000625,Grethe Torvik,2011,krf,49,52,Ikke valgt,31,4,7571,2.44,Kristelig Folkeparti,35,2011-09-12,3,0.0528206630363588,0,10,10
kandidat000626,Gro Balas,2015,ap,31,20,Vara,1508,68,102431,31.97,Arbeiderpartiet,1576,2015-09-14,276,8.97396577365121,22,3516,3494
kandidat000627,Gro Bratteli Jamholt,2007,ap,19,18,Vara,1090,36,81265,29.89,Det norske Arbeiderparti,1126,2007-09-10,4,7.44326759705252e-12,0,11,11
kandidat000628,Gro Bratteli Jamholt,2011,ap,32,25,Vara,906,31,102707,33.1,Det norske Arbeiderparti,937,2011-09-12,17,1.3886319901021e-07,0,28,28
kandidat000629,Gro Bratteli Jamholt,2015,ap,49,36,Ikke valgt,797,19,102431,31.97,Arbeiderpartiet,816,2015-09-14,177,0.00143303357840612,0,205,205
kandidat000630,Gro Lindstad,2007,sv,14,14,Vara,555,102,28701,10.56,Sosialistisk Venstreparti,657,2007-09-10,18,1.00897895136987,1,176,175
kandidat000631,Gro Standnes,2007,sv,47,53,Ikke valgt,126,7,28701,10.56,Sosialistisk Venstreparti,133,2007-09-10,30,0.00220317294287916,0,195,195
kandidat000632,Gry Orfei Solbraa,2007,mdg,21,18,Ikke valgt,17,9,1687,0.62,Miljøpartiet De Grønne,26,2007-09-10,13,1.84850876105635,3,13,10
kandidat000633,Gudny Dæhlin,2007,mdg,59,64,Ikke valgt,4,0,1687,0.62,Miljøpartiet De Grønne,4,NA,0,0,0,0,0
kandidat000634,Gudrun Jære Hoel,2015,v,53,34,Ikke valgt,77,16,21986,6.86,Venstre,93,NA,0,0,0,0,0
kandidat000635,Gülay Kutal,2011,sv,4,3,Valgt,890,303,19477,6.28,Sosialistisk Venstreparti,1193,2011-09-12,190,7.302606928039,8,394,386
kandidat000636,Gülay Kutal,2015,sv,6,7,Vara,732,286,17445,5.44,Sosialistisk Venstreparti,1018,2015-09-14,259,10.1455712781177,14,653,639
kandidat000637,Gulsum Koc,2015,h,32,23,Vara,557,77,101882,31.8,Høyre,634,2015-09-14,50,1.63280146782178,2,52,50
kandidat000638,Gülsüm Koc,2011,h,28,33,Vara,606,102,110776,35.7,Høyre,708,2011-09-12,1,0.977262483773277,1,1,0
kandidat000639,Gunnar Bloch-Hoell,2007,krf,44,22,Ikke valgt,26,2,8368,3.08,Kristelig Folkeparti,28,NA,0,0,0,0,0
kandidat000640,Gunnar Danielsen,2007,dem,46,22,Ikke valgt,0,0,306000,0.11,Demokratene,0,2007-09-10,34,3.71344676184469,6,73,67
kandidat000641,Gunnar Egil Myhre,2011,pp,5,30,Ikke valgt,22,1,1045,0.34,Pensjonistpartiet,23,2011-09-12,4,1.55332825349164,2,4,2
kandidat000642,Gunnar Grøvslien,2015,pp,18,20,Ikke valgt,10,1,1169,0.36,Pensjonistpartiet,11,NA,0,0,0,0,0
kandidat000643,Gunnar Kr. Olsen,2007,frp,50,43,Ikke valgt,96,3,38873,14.3,Fremskrittspartiet,99,2007-09-10,4,0.265084764294375,0,9,9
kandidat000644,Gunnar Kvalvaag,2007,krf,9,9,Ikke valgt,131,15,8368,3.08,Kristelig Folkeparti,146,2007-09-10,8,1.49031783789792,2,57,55
kandidat000645,Gunnar Kvalvaag,2011,krf,28,41,Ikke valgt,76,4,7571,2.44,Kristelig Folkeparti,80,2011-09-12,15,1.58395971233954,2,72,70
kandidat000646,Gunnar Kvalvaag,2015,krf,13,16,Ikke valgt,141,7,7827,2.44,Kristelig Folkeparti,148,2015-09-14,19,0.66153633512578,1,91,90
kandidat000647,Gunnar Larne,2007,h,58,43,Ikke valgt,184,8,68475,25.19,Høyre,192,2007-09-10,12,0.0752416594854898,0,26,26
kandidat000648,Gunnar Løchø Brevig,2011,v,52,28,Ikke valgt,84,2,25351,8.17,Venstre,86,2011-09-12,2,0.616931072582556,1,2,1
kandidat000649,Gunnar Moen Salberg,2007,dlf,12,13,Ikke valgt,3,0,127000,0.05,Det Liberale Folkepartiet,3,NA,0,0,0,0,0
kandidat000650,Gunnar Moen Salberg,2011,dlf,10,8,Ikke valgt,5,0,247000,0.08,Det Liberale Folkepartiet,5,2011-09-12,1,1.36288831518778e-13,0,14,14
kandidat000651,Gunnar Prestegård,2007,krf,3,5,Vara,610,101,8368,3.08,Kristelig Folkeparti,711,2007-09-10,273,5.56237717912068,10,1291,1281
kandidat000652,Gunnar Prestegård,2011,krf,3,15,Vara,554,64,7571,2.44,Kristelig Folkeparti,618,2011-09-12,304,4.19567910539576,9,1595,1586
kandidat000653,Gunnar Prestegård,2015,krf,3,8,Vara,470,52,7827,2.44,Kristelig Folkeparti,522,2015-09-14,298,12.9552867165474,31,1893,1862
kandidat000654,Gunnar Rein Olsen,2007,krf,29,17,Ikke valgt,51,2,8368,3.08,Kristelig Folkeparti,53,2007-09-10,4,0.00382668974908266,0,19,19
kandidat000655,Gunnar Rein Olsen,2011,krf,51,46,Ikke valgt,27,3,7571,2.44,Kristelig Folkeparti,30,2011-09-12,9,0.0187075663726558,0,28,28
kandidat000656,Gunnar Rein Olsen,2015,krf,41,23,Ikke valgt,42,4,7827,2.44,Kristelig Folkeparti,46,2015-09-14,5,1.68322790175699,2,33,31
kandidat000657,Gunnell-Erika Sandanger,2015,sv,39,33,Ikke valgt,162,8,17445,5.44,Sosialistisk Venstreparti,170,NA,0,0,0,0,0
kandidat000658,Gunnell Sandanger,2007,sv,54,45,Ikke valgt,101,7,28701,10.56,Sosialistisk Venstreparti,108,2007-09-10,90,7.5218511828361,10,90,80
kandidat000659,Gunnell Sandanger,2011,sv,53,47,Ikke valgt,72,7,19477,6.28,Sosialistisk Venstreparti,79,2011-09-12,79,4.27099024959442,17,169,152
kandidat000660,Gunn Erna Pound,2015,rv,26,15,Ikke valgt,153,19,16174,5.05,Rødt,172,2015-09-14,2,0.0914466169586514,1,2,1
kandidat000661,Gunnhild Skrøvseth,2015,sp,52,48,Ikke valgt,4,0,1926,0.6,Senterpartiet,4,2015-09-14,9,8.20027997096935e-12,0,9,9
kandidat000662,Gunnhild Sørås,2011,krf,32,51,Ikke valgt,69,2,7571,2.44,Kristelig Folkeparti,71,2011-09-12,207,4.97926384000762,12,349,337
kandidat000663,Gunnhild Svare,2007,mdg,53,56,Ikke valgt,6,0,1687,0.62,Miljøpartiet De Grønne,6,2007-09-10,3,1.87530986178396e-11,0,3,3
kandidat000664,Gunvor Sæther,2007,mdg,54,62,Ikke valgt,5,1,1687,0.62,Miljøpartiet De Grønne,6,2007-09-10,40,0.000673491687470082,0,73,73
kandidat000665,Guri Melby,2015,v,1,1,Valgt,3753,1029,21986,6.86,Venstre,4782,2015-09-14,5657,312.56510417473,619,6184,5565
kandidat000666,Guri Mugaas,2011,rv,51,52,Ikke valgt,50,1,11257,3.63,Rødt,51,2011-09-12,1,1.39783619357725e-05,0,22,22
kandidat000667,Guri Pahle Glad,2007,sv,20,27,Ikke valgt,388,41,28701,10.56,Sosialistisk Venstreparti,429,2007-09-10,31,0.0199857383274541,0,294,294
kandidat000668,Guri Pahle Glad,2011,sv,21,23,Ikke valgt,205,19,19477,6.28,Sosialistisk Venstreparti,224,2011-09-12,30,0.0182824019155268,0,324,324
kandidat000669,Guri Waalen Borch,2015,sv,23,27,Ikke valgt,261,19,17445,5.44,Sosialistisk Venstreparti,280,2015-09-14,133,2.72733818634836,5,139,134
kandidat000670,Guro Fjellanger,2007,v,3,4,Valgt,1665,409,23703,8.72,Venstre,2074,2007-09-10,349,14.5946956948876,25,3257,3232
kandidat000671,Guro Fjellanger,2011,v,3,4,Valgt,1228,274,25351,8.17,Venstre,1502,2011-09-12,506,12.6064599611787,27,3763,3736
kandidat000672,Guro Fjellanger,2015,v,10,29,Vara,367,62,21986,6.86,Venstre,429,2015-09-14,260,3.66318232511337,7,4023,4016
kandidat000673,Guro Svenkerud Fresvik,2007,v,48,34,Ikke valgt,129,2,23703,8.72,Venstre,131,2007-09-10,5,0.977295849636436,1,5,4
kandidat000674,Guro Svenkerud Fresvik,2015,v,30,31,Ikke valgt,160,8,21986,6.86,Venstre,168,2015-09-14,17,2.10642105727685,3,50,47
kandidat000675,Gustava Ording Bugge,2007,sp,49,44,Ikke valgt,7,0,2189,0.81,Senterpartiet,7,2007-09-10,1,0.00492712315397501,0,4,4
kandidat000676,Gyrd Steen,2007,osby,48,40,Ikke valgt,7,3,1466,0.54,Oslo Byaksjon,10,2007-09-10,27,0.186601232787655,1,231,230
kandidat000677,Gyro Sølvsberg,2011,krf,44,50,Ikke valgt,42,6,7571,2.44,Kristelig Folkeparti,48,2011-09-12,22,1.72349153450317,4,35,31
kandidat000678,Gyro Sølvsberg,2015,krf,45,41,Ikke valgt,30,7,7827,2.44,Kristelig Folkeparti,37,2015-09-14,36,1.19642398984278e-09,0,71,71
kandidat000679,Haakon Brænden,2007,krf,30,24,Ikke valgt,44,5,8368,3.08,Kristelig Folkeparti,49,2007-09-10,14,5.8462898035077,10,25,15
kandidat000680,Haakon Brænden,2011,krf,10,9,Ikke valgt,196,13,7571,2.44,Kristelig Folkeparti,209,2011-09-12,181,14.3406787896672,32,206,174
kandidat000681,Haakon Haugen,2007,pp,6,34,Ikke valgt,10,11,1414,0.52,Pensjonistpartiet,21,2007-09-10,26,0.0408288054365096,0,57,57
kandidat000682,Haakon Peter Riekeles,2011,v,14,13,Ikke valgt,309,34,25351,8.17,Venstre,343,2011-09-12,2,9.38941699557495e-11,0,7,7
kandidat000683,Haakon Sperre,2015,lib,6,5,Ikke valgt,32,5,458,0.14,Liberalistene Oslo,37,2015-09-14,12,0.756905289678238,3,13,10
kandidat000684,Habte-Ab Asgedom,2007,krf,22,20,Ikke valgt,66,2,8368,3.08,Kristelig Folkeparti,68,NA,0,0,0,0,0
kandidat000685,Hafida Yakhlef,2007,in,9,8,Ikke valgt,28,25,329000,0.12,Innvandrerpartiet,53,2007-09-10,1,5.47220007985274e-08,0,1,1
kandidat000686,Håkon Gundersen,2007,osby,60,59,Ikke valgt,4,1,1466,0.54,Oslo Byaksjon,5,2007-09-10,307,6.9382666825139,12,504,492
kandidat000687,Håkon Haugli,2007,ap,15,13,Valgt,1132,240,81265,29.89,Det norske Arbeiderparti,1372,2007-09-10,565,67.4842202042078,232,638,406
kandidat000688,Håkon Haugli,2011,ap,29,36,Vara,888,129,102707,33.1,Det norske Arbeiderparti,1017,2011-09-12,2199,45.7408357744837,128,2837,2709
kandidat000689,Håkon Wium Lie,2015,pirat,2,3,Ikke valgt,61,75,805,0.25,Piratpartiet,136,2015-09-14,387,15.0647473783925,55,1127,1072
kandidat000690,Hallstein Braaten Bjercke,2007,v,39,24,Ikke valgt,159,20,23703,8.72,Venstre,179,2007-09-10,14,0.461441894663691,1,45,44
kandidat000691,Hallstein Braaten Bjercke,2011,v,32,24,Ikke valgt,126,29,25351,8.17,Venstre,155,2011-09-12,83,0.00711891488348456,0,128,128
kandidat000692,Hallstein Braaten Bjercke,2015,v,2,2,Valgt,1202,295,21986,6.86,Venstre,1497,2015-09-14,25,1.26708130378028,2,153,151
kandidat000693,Hallvard Sandvik,2011,ksp,4,3,Ikke valgt,13,4,235000,0.08,Kristent Samlingsparti,17,2011-09-12,61,0.143774625190158,1,74,73
kandidat000694,Halvor Bodin,2007,osby,53,64,Ikke valgt,5,3,1466,0.54,Oslo Byaksjon,8,2007-09-10,64,1.43293520277856,3,102,99
kandidat000695,Halvor Hartvig Gundersen,2011,sp,46,34,Ikke valgt,7,1,1591,0.51,Senterpartiet,8,NA,0,0,0,0,0
kandidat000696,Halvor Kolsrud,2007,sv,29,32,Ikke valgt,222,13,28701,10.56,Sosialistisk Venstreparti,235,NA,0,0,0,0,0
kandidat000697,Hamsa Farah Mohamed,2011,sv,6,4,Vara,771,151,19477,6.28,Sosialistisk Venstreparti,922,2011-09-12,6,2.25163355511596e-07,0,6,6
kandidat000698,Hamsa Mohamed,2007,sv,12,13,Vara,1224,77,28701,10.56,Sosialistisk Venstreparti,1301,2007-09-10,32,3.60220639116183,4,32,28
kandidat000699,Hanna Breistrand,2007,rv,46,51,Ikke valgt,49,1,14131,5.2,Rød Valgallianse,50,2007-09-10,13,9.74722386023865e-07,0,14,14
kandidat000700,Hanna Elise Marcussen,2007,mdg,24,48,Ikke valgt,19,5,1687,0.62,Miljøpartiet De Grønne,24,NA,0,0,0,0,0
kandidat000701,Hanna Elise Marcussen,2011,mdg,2,2,Vara,823,301,7653,2.47,Miljøpartiet De Grønne,1124,2011-09-12,10,1.0019768096801,1,10,9
kandidat000702,Hanna Elise Marcussen,2015,mdg,6,9,Vara,1057,118,26096,8.14,Miljøpartiet De Grønne,1175,2015-09-14,72,3.50518099630487e-07,0,82,82
kandidat000703,Hannah Helseth,2015,sv,21,49,Ikke valgt,267,42,17445,5.44,Sosialistisk Venstreparti,309,2015-09-14,464,1.40925338245215,5,1049,1044
kandidat000704,Hanna-Mari Anttila-Kvåle,2007,sp,37,28,Ikke valgt,10,1,2189,0.81,Senterpartiet,11,2007-09-10,2,0.00492713313080933,0,2,2
kandidat000705,Hanna-Mari Anttila-Kvåle,2011,sp,20,17,Ikke valgt,15,2,1591,0.51,Senterpartiet,17,2011-09-12,2,0.0030184628406133,0,4,4
kandidat000706,Hanna-Mari Helena Anttila-Kvåle,2015,sp,38,45,Ikke valgt,15,1,1926,0.6,Senterpartiet,16,NA,0,0,0,0,0
kandidat000707,Hanna Mikalsen,2007,sv,37,49,Ikke valgt,169,8,28701,10.56,Sosialistisk Venstreparti,177,2007-09-10,9,0.658482743472872,1,12,11
kandidat000708,Hanna Norheim,2007,krf,46,50,Ikke valgt,26,2,8368,3.08,Kristelig Folkeparti,28,2007-09-10,6,0.0647786195177323,0,6,6
kandidat000709,Hanna Vesterager,2007,rv,64,57,Ikke valgt,26,3,14131,5.2,Rød Valgallianse,29,2007-09-10,16,1.60250181723273,6,31,25
kandidat000710,Hanne Birkelund,2007,v,33,23,Ikke valgt,190,7,23703,8.72,Venstre,197,2007-09-10,3,0.0152081899645391,0,10,10
kandidat000711,Hanne Eldby,2015,sv,17,17,Ikke valgt,342,42,17445,5.44,Sosialistisk Venstreparti,384,2015-09-14,185,4.35270782980698,7,627,620
kandidat000712,Hanne F. Dahle,2007,sv,31,47,Ikke valgt,205,7,28701,10.56,Sosialistisk Venstreparti,212,2007-09-10,1,0.91210514954509,1,2,1
kandidat000713,Hanne Grasmo,2007,mdg,27,28,Ikke valgt,18,2,1687,0.62,Miljøpartiet De Grønne,20,2007-09-10,5,0.00242811306287352,0,78,78
kandidat000714,Hanne Hodnebrug,2007,krf,5,4,Vara,202,21,8368,3.08,Kristelig Folkeparti,223,2007-09-10,29,5.28208817085446,7,38,31
kandidat000715,Hanne Hodnebrug,2011,krf,20,10,Ikke valgt,115,12,7571,2.44,Kristelig Folkeparti,127,2011-09-12,119,1.93271894998061,2,157,155
kandidat000716,Hanne Størset,2015,fi,28,22,Ikke valgt,18,1,1388,0.43,Feministisk Initiativ,19,2015-09-14,16,0.0281449548321093,0,83,83
kandidat000717,Hans A. Borgen,2011,mdg,27,35,Ikke valgt,43,9,7653,2.47,Miljøpartiet De Grønne,52,2011-09-12,2,0.0528206630363544,0,31,31
kandidat000718,Hans Anders Borgen,2007,mdg,9,10,Ikke valgt,56,11,1687,0.62,Miljøpartiet De Grønne,67,2007-09-10,2,1.57100148432707,2,4,2
kandidat000719,Hans A. Omland,2007,krf,47,51,Ikke valgt,23,5,8368,3.08,Kristelig Folkeparti,28,2007-09-10,1,0.91210514954509,1,3,2
kandidat000720,Hans Arne Akerø,2015,krf,20,24,Ikke valgt,124,9,7827,2.44,Kristelig Folkeparti,133,2015-09-14,342,1.47823000012987,6,470,464
kandidat000721,Hans Asbjørn Holm,2011,ap,64,62,Ikke valgt,273,5,102707,33.1,Det norske Arbeiderparti,278,2011-09-12,10,0.0793214238448563,0,141,141
kandidat000722,Hans Birger Nielsen,2007,frp,49,40,Ikke valgt,103,1,38873,14.3,Fremskrittspartiet,104,2007-09-10,5,0.912108289037333,1,12,11
kandidat000723,Hans Christian Lillehagen,2011,ap,36,22,Vara,770,37,102707,33.1,Det norske Arbeiderparti,807,2011-09-12,318,46.8192635980774,66,341,275
kandidat000724,Hans Christian Lillehagen,2015,ap,63,55,Ikke valgt,433,17,102431,31.97,Arbeiderpartiet,450,2015-09-14,340,3.14967919806805,4,681,677
kandidat000725,Hans Flatøy,2007,kp,34,15,Ikke valgt,1,0,120000,0.04,Kystpartiet,1,NA,0,0,0,0,0
kandidat000726,Hans Høegh Henrichsen,2011,frp,18,15,Ikke valgt,163,2,21852,7.04,Fremskrittspartiet,165,2011-09-12,55,2.70219053842629,10,102,92
kandidat000727,Hans H. Skei,2007,sp,45,48,Ikke valgt,6,2,2189,0.81,Senterpartiet,8,2007-09-10,358,18.0437936805323,29,764,735
kandidat000728,Hans Joar Høiby Hansen,2007,mdg,4,2,Ikke valgt,89,57,1687,0.62,Miljøpartiet De Grønne,146,NA,0,0,0,0,0
kandidat000729,Hans Jokinen,2007,nkp,7,5,Ikke valgt,11,2,203000,0.07,Norges Kommunistiske Parti,13,NA,0,0,0,0,0
kandidat000730,Hans Jørgen Gjertsen,2007,krf,61,32,Ikke valgt,18,4,8368,3.08,Kristelig Folkeparti,22,2007-09-10,1,1.02353859775942e-09,0,45,45
kandidat000731,Hans Jørgen Lysglimt,2015,pirat,10,7,Ikke valgt,29,6,805,0.25,Piratpartiet,35,2015-09-14,17,1.84543197497265,2,73,71
kandidat000732,Hans Kristian Voldstad,2015,v,18,14,Ikke valgt,215,50,21986,6.86,Venstre,265,2015-09-14,20,1.63216771679942e-05,0,39,39
kandidat000733,Hans Otto Jespersen,2007,sfp,3,3,Ikke valgt,11,16,129000,0.05,Samfunnspartiet,27,2007-09-10,7,2.11276465163928e-05,0,26,26
kandidat000734,Hans Otto Watne,2011,frp,48,46,Ikke valgt,69,1,21852,7.04,Fremskrittspartiet,70,2011-09-12,29,1.35267328297701,2,33,31
kandidat000735,Hans Otto Watne,2015,frp,29,27,Ikke valgt,119,6,19311,6.03,Fremskrittspartiet,125,2015-09-14,4,2.11119833878422,3,37,34
kandidat000736,Hans-Petter Aas,2007,sv,8,5,Vara,685,115,28701,10.56,Sosialistisk Venstreparti,800,2007-09-10,374,11.499562091686,21,699,678
kandidat000737,Hans Petter de Fine,2007,rv,10,9,Ikke valgt,200,10,14131,5.2,Rød Valgallianse,210,NA,0,0,0,0,0
kandidat000738,Hans Petter Hansen,2007,nkp,8,7,Ikke valgt,10,3,203000,0.07,Norges Kommunistiske Parti,13,2007-09-10,349,10.9344818866062,22,659,637
kandidat000739,Hans Petter Hansen,2011,nkp,12,12,Ikke valgt,11,1,210000,0.07,Norges Kommunistiske Parti,12,2011-09-12,441,8.5297826596724,17,1100,1083
kandidat000740,Hans Petter Hansen,2015,nkp,11,12,Ikke valgt,16,1,240,0.07,Norges Kommunistiske Parti,17,2015-09-14,289,8.17030260910467,25,1389,1364
kandidat000741,Hans Robin Solberg,2011,nkp,10,9,Ikke valgt,10,3,210000,0.07,Norges Kommunistiske Parti,13,NA,0,0,0,0,0
kandidat000742,Hans Stefan Jokinen,2011,nkp,9,11,Ikke valgt,15,0,210000,0.07,Norges Kommunistiske Parti,15,NA,0,0,0,0,0
kandidat000743,Harald A. Nissen,2011,mdg,1,1,Valgt,1263,641,7653,2.47,Miljøpartiet De Grønne,1904,2011-09-12,83,29.8157219802992,47,174,127
kandidat000744,Harald August Nissen,2015,mdg,3,2,Valgt,1299,380,26096,8.14,Miljøpartiet De Grønne,1679,2015-09-14,62,13.002908502924,13,69,56
kandidat000745,Harald Hansen,2015,lib,3,3,Ikke valgt,41,11,458,0.14,Liberalistene Oslo,52,2015-09-14,1934,43.1210376279863,91,5484,5393
kandidat000746,Harald Høyem,2015,sp,17,13,Ikke valgt,35,4,1926,0.6,Senterpartiet,39,2015-09-14,12,1.47041090265779,2,54,52
kandidat000747,Harald Kristoffersen,2007,kp,1,1,Ikke valgt,19,21,120000,0.04,Kystpartiet,40,2007-09-10,176,4.73220081788194,24,292,268
kandidat000748,Harald Kristoffersen,2011,kp,3,14,Ikke valgt,11,2,126000,0.04,Kystpartiet,13,2011-09-12,245,5.33318642957928,15,537,522
kandidat000749,Harald Kristoffersen,2015,kp,13,9,Ikke valgt,5,0,124,0.04,Kystpartiet,5,2015-09-14,52,1.2749811597809,5,589,584
kandidat000750,Harald Nedrelid,2007,krf,50,48,Ikke valgt,26,0,8368,3.08,Kristelig Folkeparti,26,NA,0,0,0,0,0
kandidat000751,Harald Olav Torhaug,2011,kp,15,19,Ikke valgt,3,0,126000,0.04,Kystpartiet,3,NA,0,0,0,0,0
kandidat000752,Harald Olav Torhaug,2015,kp,17,15,Ikke valgt,2,0,124,0.04,Kystpartiet,2,NA,0,0,0,0,0
kandidat000753,Harald Olsen,2007,nkp,20,21,Ikke valgt,3,1,203000,0.07,Norges Kommunistiske Parti,4,2007-09-10,2293,95.6565468798998,163,4489,4326
kandidat000754,Harald Ø. Lund,2007,osby,56,47,Ikke valgt,4,3,1466,0.54,Oslo Byaksjon,7,NA,0,0,0,0,0
kandidat000755,Harald Schyberg,2007,mdg,63,37,Ikke valgt,2,0,1687,0.62,Miljøpartiet De Grønne,2,2007-09-10,5,0.111549516140268,0,5,5
kandidat000756,Harald Stabell,2011,rv,16,61,Ikke valgt,217,43,11257,3.63,Rødt,260,2011-09-12,10452,228.230569770415,1008,22326,21318
kandidat000757,Harald Stabell,2015,rv,17,65,Ikke valgt,417,70,16174,5.05,Rødt,487,2015-09-14,11468,79.0814803022765,138,33794,33656
kandidat000758,Harald Storvik,2015,pp,21,19,Ikke valgt,8,1,1169,0.36,Pensjonistpartiet,9,2015-09-14,110,2.2107343476672,3,261,258
kandidat000759,Harald Torhaug,2007,kp,46,41,Ikke valgt,0,0,120000,0.04,Kystpartiet,0,2007-09-10,4,1.00001498331469,1,18,17
kandidat000760,Hardi Ahmadi,2007,v,18,18,Ikke valgt,320,27,23703,8.72,Venstre,347,2007-09-10,4,0.784779139472964,1,4,3
kandidat000761,Hardi Ahmadi,2011,v,18,17,Ikke valgt,235,20,25351,8.17,Venstre,255,2011-09-12,1,0.977262483773277,1,5,4
kandidat000762,Hårek Hansen,2015,frp,14,10,Ikke valgt,200,29,19311,6.03,Fremskrittspartiet,229,2015-09-14,33,0.248575128250404,0,106,106
kandidat000763,Harriet Karoliussen,2007,osby,42,45,Ikke valgt,8,5,1466,0.54,Oslo Byaksjon,13,2007-09-10,44,1.59734120220462,2,137,135
kandidat000764,Hartvig Opsjøn,2007,krf,24,19,Ikke valgt,57,9,8368,3.08,Kristelig Folkeparti,66,2007-09-10,24,2.52863441016211,4,30,26
kandidat000765,Hartvig Opsjøn,2011,krf,34,23,Ikke valgt,63,5,7571,2.44,Kristelig Folkeparti,68,2011-09-12,8,3.07230220728341,6,38,32
kandidat000766,Hartvig Opsjøn,2015,krf,43,44,Ikke valgt,37,5,7827,2.44,Kristelig Folkeparti,42,2015-09-14,9,1.72326876672917,3,47,44
kandidat000767,Hauk Heyerdahl,2007,osby,57,58,Ikke valgt,6,1,1466,0.54,Oslo Byaksjon,7,2007-09-10,51,0.266604758335836,0,87,87
kandidat000768,Håvard Grastveit,2011,sp,38,33,Ikke valgt,9,1,1591,0.51,Senterpartiet,10,2011-09-12,15,0.00301846523594231,0,17,17
kandidat000769,Håvard Grastveit,2015,sp,10,10,Ikke valgt,42,11,1926,0.6,Senterpartiet,53,2015-09-14,6,1.13292324511462,3,23,20
kandidat000770,Håvard Haagenrud,2015,v,54,32,Ikke valgt,87,3,21986,6.86,Venstre,90,NA,0,0,0,0,0
kandidat000771,Hege Astrup Sannum,2015,h,38,32,Vara,501,25,101882,31.8,Høyre,526,2015-09-14,16,0.0135999184508451,0,21,21
kandidat000772,Hege Solbakken,2007,sp,18,26,Ikke valgt,25,5,2189,0.81,Senterpartiet,30,2007-09-10,110,2.3764422184367,6,175,169
kandidat000773,Hege Solbakken,2011,sp,10,5,Ikke valgt,33,9,1591,0.51,Senterpartiet,42,2011-09-12,1343,73.3301304550823,246,1518,1272
kandidat000774,Heidi Fuglesang,2015,h,41,41,Vara,467,18,101882,31.8,Høyre,485,2015-09-14,139,0.525719822908047,0,159,159
kandidat000775,Heidi Hovind,2015,pirat,7,16,Ikke valgt,32,8,805,0.25,Piratpartiet,40,2015-09-14,4,0.000143886105316349,0,5,5
kandidat000776,Heidi Marikken Sund,2007,sv,42,41,Ikke valgt,142,8,28701,10.56,Sosialistisk Venstreparti,150,NA,0,0,0,0,0
kandidat000777,Heidi Rømming,2007,sv,5,4,Valgt,1055,139,28701,10.56,Sosialistisk Venstreparti,1194,2007-09-10,24,0.0222201655132229,0,38,38
kandidat000778,Heidi Sandvand Hegertun,2015,krf,26,29,Ikke valgt,105,5,7827,2.44,Kristelig Folkeparti,110,NA,0,0,0,0,0
kandidat000779,Helene Alexandra Brekke,2007,pp,9,7,Ikke valgt,17,2,1414,0.52,Pensjonistpartiet,19,NA,0,0,0,0,0
kandidat000780,Helene Brekke,2011,dem,2,2,Ikke valgt,15,10,214000,0.07,Demokratene i Norge,25,2011-09-12,194,2.35818600890214,5,276,271
kandidat000781,Helene Falch Fladmark,2007,v,26,32,Ikke valgt,218,11,23703,8.72,Venstre,229,2007-09-10,15,0.767707107392699,1,96,95
kandidat000782,Helene Gallis,2015,mdg,24,25,Ikke valgt,303,32,26096,8.14,Miljøpartiet De Grønne,335,2015-09-14,111,12.7041559272851,24,111,87
kandidat000783,Helene Voldner,2007,rv,5,5,Vara,434,77,14131,5.2,Rød Valgallianse,511,2007-09-10,3,3.31587098776246e-05,0,9,9
kandidat000784,Helge Rege Gårdsvoll,2011,krf,46,34,Ikke valgt,44,1,7571,2.44,Kristelig Folkeparti,45,2011-09-12,6,1.51466924706997,2,6,4
kandidat000785,Helle Grøndahl,2015,fi,19,12,Ikke valgt,28,6,1388,0.43,Feministisk Initiativ,34,2015-09-14,10,1.43057897430292,7,10,3
kandidat000786,Helle Hagenau,2011,rv,8,4,Ikke valgt,235,54,11257,3.63,Rødt,289,2011-09-12,6,0.636984495639921,1,68,67
kandidat000787,Helle Hagenau,2015,rv,8,7,Vara,353,46,16174,5.05,Rødt,399,2015-09-14,7,0.0876107041744732,0,75,75
kandidat000788,Henning Holstad,2007,frp,5,4,Valgt,926,54,38873,14.3,Fremskrittspartiet,980,2007-09-10,495,58.7931273502187,70,1700,1630
kandidat000789,Henning Holstad,2011,frp,9,9,Vara,389,44,21852,7.04,Fremskrittspartiet,433,2011-09-12,1039,15.2902063101373,21,2739,2718
kandidat000790,Henning Rokling-Andersen,2007,h,45,48,Ikke valgt,254,6,68475,25.19,Høyre,260,2007-09-10,27,1.15017971282944e-08,0,31,31
kandidat000791,Henning Solhaug,2007,sv,56,50,Ikke valgt,93,8,28701,10.56,Sosialistisk Venstreparti,101,2007-09-10,23,0.166727609647548,1,64,63
kandidat000792,Henning Stene,2015,h,56,53,Ikke valgt,308,16,101882,31.8,Høyre,324,2015-09-14,26,0.608900693873292,1,171,170
kandidat000793,Henny Strøm,2007,v,62,57,Ikke valgt,68,3,23703,8.72,Venstre,71,2007-09-10,2,0.696597228000182,2,4,2
kandidat000794,Henriette Westhrin,2015,sv,29,43,Ikke valgt,209,13,17445,5.44,Sosialistisk Venstreparti,222,2015-09-14,1430,0.0506394355768013,0,5302,5302
kandidat000795,Henrik Gjerding,2011,frp,31,51,Ikke valgt,92,25,21852,7.04,Fremskrittspartiet,117,2011-09-12,3,0.189090320890197,1,8,7
kandidat000796,Henrik Holst,2011,ap,49,54,Ikke valgt,479,26,102707,33.1,Det norske Arbeiderparti,505,2011-09-12,62,0.139561062044089,1,87,86
kandidat000797,Henrik Hovland,2011,ap,61,60,Ikke valgt,352,13,102707,33.1,Det norske Arbeiderparti,365,2011-09-12,606,1.70148336729251,5,1069,1064
kandidat000798,Henrik Hovland,2015,ap,65,53,Ikke valgt,406,5,102431,31.97,Arbeiderpartiet,411,2015-09-14,195,12.3226644166259,36,1264,1228
kandidat000799,Henrik Sander,2011,frp,25,30,Ikke valgt,113,15,21852,7.04,Fremskrittspartiet,128,2011-09-12,100,5.38006616897877,8,217,209
kandidat000800,Henry Tschudi,2007,kp,47,43,Ikke valgt,0,0,120000,0.04,Kystpartiet,0,2007-09-10,5,1.55295563713384,2,12,10
kandidat000801,Henry Tschudi,2015,kp,18,16,Ikke valgt,1,0,124,0.04,Kystpartiet,1,2015-09-14,39,0.00519088600118581,0,65,65
kandidat000802,Herbert Boretti,2007,nkp,21,20,Ikke valgt,2,1,203000,0.07,Norges Kommunistiske Parti,3,NA,0,0,0,0,0
kandidat000803,Hermann Kopp,2007,h,14,41,Valgt,1309,78,68475,25.19,Høyre,1387,2007-09-10,31,1.60468492904283,4,75,71
kandidat000804,Hermann Kopp,2011,h,14,35,Valgt,1445,70,110776,35.7,Høyre,1515,2011-09-12,115,1.42220341194035,3,190,187
kandidat000805,Hermann Kopp,2015,h,20,28,Vara,1033,78,101882,31.8,Høyre,1111,2015-09-14,172,0.0237486422077526,0,362,362
kandidat000806,Hermann Smith-Sivertsen,2011,h,40,51,Vara,477,32,110776,35.7,Høyre,509,2011-09-12,10,0.173073169482894,1,79,78
kandidat000807,Hermann Smith-Sivertsen,2015,h,27,19,Vara,696,37,101882,31.8,Høyre,733,2015-09-14,58,1.55368399775257,6,137,131
kandidat000808,Hernán Rojas,2007,sv,26,30,Ikke valgt,258,40,28701,10.56,Sosialistisk Venstreparti,298,2007-09-10,16,1.43003607767726,1,29,28
kandidat000809,Hildegunn Hodne Ulltveit-Moe,2015,krf,46,45,Ikke valgt,33,3,7827,2.44,Kristelig Folkeparti,36,2015-09-14,2,1.24821346888047,2,3,1
kandidat000810,Hilde Jordal Myrset,2007,frp,34,39,Ikke valgt,160,1,38873,14.3,Fremskrittspartiet,161,NA,0,0,0,0,0
kandidat000811,Hilde Lysengen Havro,2007,sp,11,12,Ikke valgt,40,3,2189,0.81,Senterpartiet,43,2007-09-10,7,0.0653788600521125,0,18,18
kandidat000812,Hilde Maisey,2007,sv,22,16,Ikke valgt,368,36,28701,10.56,Sosialistisk Venstreparti,404,2007-09-10,5,0.509929715888536,3,28,25
kandidat000813,Hilde Maisey,2011,sv,13,9,Ikke valgt,328,31,19477,6.28,Sosialistisk Venstreparti,359,2011-09-12,97,0.343266801422858,1,125,124
kandidat000814,Hilde Vestrheim,2015,v,12,9,Ikke valgt,334,28,21986,6.86,Venstre,362,2015-09-14,1,0.000621732886741333,0,3,3
kandidat000815,Hilde Widerøe Wibe,2011,v,50,62,Ikke valgt,81,7,25351,8.17,Venstre,88,2011-09-12,114,5.42562145532499,16,229,213
kandidat000816,Hirut Worku,2015,krf,55,51,Ikke valgt,19,2,7827,2.44,Kristelig Folkeparti,21,2015-09-14,5,8.16906493782588e-09,0,13,13
kandidat000817,Honoratte Muhanzi Kashale,2015,krf,54,33,Ikke valgt,22,2,7827,2.44,Kristelig Folkeparti,24,2015-09-14,2,1.39789790296204e-05,0,27,27
kandidat000818,Huaytacha Nygaard,2011,kp,7,3,Ikke valgt,2,4,126000,0.04,Kystpartiet,6,NA,0,0,0,0,0
kandidat000819,Huaytacha Tennfjord,2007,kp,7,5,Ikke valgt,5,3,120000,0.04,Kystpartiet,8,2007-09-10,2,1.50831595986596,2,4,2
kandidat000820,Hugo Fredriksen,2011,sp,43,31,Ikke valgt,6,3,1591,0.51,Senterpartiet,9,2011-09-12,51,0.0111995096812704,0,98,98
kandidat000821,Hussain Shafqat Chaudry,2007,in,1,9,Ikke valgt,39,163,329000,0.12,Innvandrerpartiet,202,NA,0,0,0,0,0
kandidat000822,Hussein Aden Yussuf,2015,sv,22,30,Ikke valgt,262,24,17445,5.44,Sosialistisk Venstreparti,286,NA,0,0,0,0,0
kandidat000823,Ibrahim Sheikh M. Ahmed,2007,sp,7,6,Ikke valgt,61,26,2189,0.81,Senterpartiet,87,NA,0,0,0,0,0
kandidat000824,Ibrahim Sheikh Mohamed Ahmed,2011,sp,9,6,Ikke valgt,21,23,1591,0.51,Senterpartiet,44,2011-09-12,4,0.0030185774366268,0,4,4
kandidat000825,Ida Beth Hald,2011,mdg,16,18,Ikke valgt,65,24,7653,2.47,Miljøpartiet De Grønne,89,2011-09-12,14,1.57367154606699,2,27,25
kandidat000826,Ida Beth Hald,2015,mdg,31,27,Ikke valgt,221,22,26096,8.14,Miljøpartiet De Grønne,243,2015-09-14,4,8.77460085375932e-07,0,31,31
kandidat000827,Ida K. Berg-Johnsen,2011,h,24,16,Vara,773,22,110776,35.7,Høyre,795,NA,0,0,0,0,0
kandidat000828,Ida Marie Haugen Gilbert,2011,mdg,35,40,Ikke valgt,40,5,7653,2.47,Miljøpartiet De Grønne,45,2011-09-12,33,3.45394191806677,14,33,19
kandidat000829,Idar Eliassen,2007,ap,28,31,Vara,760,88,81265,29.89,Det norske Arbeiderparti,848,2007-09-10,17,0.25181632184118,1,71,70
kandidat000830,Ida Samantha Drugg,2007,mdg,6,7,Ikke valgt,78,21,1687,0.62,Miljøpartiet De Grønne,99,2007-09-10,2,0.04929893407125,0,2,2
kandidat000831,Ida Viksveen Larsen,2007,ap,26,22,Vara,858,32,81265,29.89,Det norske Arbeiderparti,890,2007-09-10,27,5.4216005001652,9,27,18
kandidat000832,Ida Viksveen Larsen,2011,ap,43,37,Vara,633,15,102707,33.1,Det norske Arbeiderparti,648,2011-09-12,16,0.0305830181247156,0,43,43
kandidat000833,Ida Viksveen Larsen,2015,ap,35,22,Vara,1343,21,102431,31.97,Arbeiderpartiet,1364,2015-09-14,89,0.0170374997980613,0,132,132
kandidat000834,Iman Winkelman,2007,h,54,63,Ikke valgt,214,4,68475,25.19,Høyre,218,2007-09-10,23,0.893414638773184,3,27,24
kandidat000835,Ina Roll Spinnangr,2015,v,26,53,Ikke valgt,144,40,21986,6.86,Venstre,184,2015-09-14,229,2.05507145536709,10,291,281
kandidat000836,Ingar Malvang,2007,dem,1,1,Ikke valgt,45,36,306000,0.11,Demokratene,81,2007-09-10,77,59.9205604901957,64,96,32
kandidat000837,Ingebjørg Hillestad,2007,sp,32,41,Ikke valgt,12,2,2189,0.81,Senterpartiet,14,2007-09-10,1,0.00492712315397501,0,4,4
kandidat000838,Ingebjørg Hillestad,2011,sp,52,37,Ikke valgt,4,2,1591,0.51,Senterpartiet,6,2011-09-12,2,0.00205598547239096,0,6,6
kandidat000839,Ingeborg Elise Vardøen,2015,mdg,59,53,Ikke valgt,105,0,26096,8.14,Miljøpartiet De Grønne,105,NA,0,0,0,0,0
kandidat000840,Ingeborg Greiner,2007,pp,28,24,Ikke valgt,7,0,1414,0.52,Pensjonistpartiet,7,NA,0,0,0,0,0
kandidat000841,Ingeborg Greiner,2011,pp,30,14,Ikke valgt,7,0,1045,0.34,Pensjonistpartiet,7,2011-09-12,1,1.19923127092213e-08,0,3,3
kandidat000842,Ingeborg Heslien,2011,sp,29,35,Ikke valgt,13,1,1591,0.51,Senterpartiet,14,2011-09-12,2,0.0030184628406133,0,4,4
kandidat000843,Ingeborg Kjos,2011,v,30,43,Ikke valgt,138,20,25351,8.17,Venstre,158,2011-09-12,48,3.91548303398379,5,51,46
kandidat000844,Ingeborg Kjos,2015,v,47,40,Ikke valgt,112,4,21986,6.86,Venstre,116,2015-09-14,28,0.0271427082315844,0,79,79
kandidat000845,Ingeborg Midttun,2007,h,46,44,Ikke valgt,247,4,68475,25.19,Høyre,251,2007-09-10,1,0.91210514954509,1,57,56
kandidat000846,Inge Carlén,2011,v,21,30,Ikke valgt,187,54,25351,8.17,Venstre,241,2011-09-12,33,1.21044269013045,2,161,159
kandidat000847,Inger Bigum,2007,sp,35,24,Ikke valgt,10,2,2189,0.81,Senterpartiet,12,2007-09-10,2,0.036672759532043,0,2,2
kandidat000848,Inger Bigum,2011,sp,36,23,Ikke valgt,9,1,1591,0.51,Senterpartiet,10,2011-09-12,12,0.0092924390233857,0,14,14
kandidat000849,Inger Bigum,2015,sp,25,17,Ikke valgt,19,6,1926,0.6,Senterpartiet,25,2015-09-14,5,0.753661597445685,1,19,18
kandidat000850,Inger Buskerud,2007,krf,38,25,Ikke valgt,29,2,8368,3.08,Kristelig Folkeparti,31,NA,0,0,0,0,0
kandidat000851,Inger Johanne Eggen,2007,sp,47,36,Ikke valgt,4,3,2189,0.81,Senterpartiet,7,2007-09-10,16,1.80862445547918,5,25,20
kandidat000852,Inger Johanne Nordås,2007,sp,21,17,Ikke valgt,23,2,2189,0.81,Senterpartiet,25,2007-09-10,7,0.338116798146938,2,7,5
kandidat000853,Inger Johanne Nordås,2011,sp,30,13,Ikke valgt,12,1,1591,0.51,Senterpartiet,13,2011-09-12,3,0.00322938951492416,0,10,10
kandidat000854,Inger Johanne Nordås,2015,sp,49,38,Ikke valgt,6,1,1926,0.6,Senterpartiet,7,2015-09-14,7,2.23637335376443e-06,0,17,17
kandidat000855,Inger Lazzeri,2007,dlf,6,7,Ikke valgt,6,0,127000,0.05,Det Liberale Folkepartiet,6,NA,0,0,0,0,0
kandidat000856,Inger Lise Lysberg,2007,kp,23,26,Ikke valgt,2,0,120000,0.04,Kystpartiet,2,NA,0,0,0,0,0
kandidat000857,Inger Lise Lysberg,2015,kp,9,11,Ikke valgt,7,1,124,0.04,Kystpartiet,8,NA,0,0,0,0,0
kandidat000858,Inger Lise Nymoen,2007,frp,41,42,Ikke valgt,137,1,38873,14.3,Fremskrittspartiet,138,2007-09-10,10,3.46945605657404,4,11,7
kandidat000859,Inger Ljøstad,2007,rv,61,62,Ikke valgt,31,3,14131,5.2,Rød Valgallianse,34,2007-09-10,12,0.0196742442284609,0,13,13
kandidat000860,Inger Lorentzen,2015,ksp,16,13,Ikke valgt,7,2,421,0.13,Partiet De Kristne,9,2015-09-14,39,1.84545693481504,2,63,61
kandidat000861,Inger Lovise Masternes,2007,sp,29,30,Ikke valgt,17,0,2189,0.81,Senterpartiet,17,2007-09-10,3,1.70751126536828,2,3,1
kandidat000862,Inger-Marie Ytterhorn,2015,frp,22,22,Ikke valgt,182,9,19311,6.03,Fremskrittspartiet,191,2015-09-14,1550,3.34822392222349,3,3210,3207
kandidat000863,Ingmar Tveitt,2007,dem,5,7,Ikke valgt,13,2,306000,0.11,Demokratene,15,2007-09-10,34,3.05165000450516e-07,0,49,49
kandidat000864,Ingrid Agnes Keenan,2015,v,31,38,Ikke valgt,150,18,21986,6.86,Venstre,168,NA,0,0,0,0,0
kandidat000865,Ingrid Ailin Strømme,2015,sp,3,3,Ikke valgt,120,23,1926,0.6,Senterpartiet,143,2015-09-14,4,1.92356824227976,3,4,1
kandidat000866,Ingrid Baltzersen,2007,rv,2,2,Valgt,802,293,14131,5.2,Rød Valgallianse,1095,2007-09-10,318,12.5402973037079,16,345,329
kandidat000867,Ingrid Baltzersen,2011,rv,3,2,Vara,696,253,11257,3.63,Rødt,949,2011-09-12,344,36.8605277881939,59,689,630
kandidat000868,Ingrid Eiane Setvik,2011,krf,15,8,Ikke valgt,141,10,7571,2.44,Kristelig Folkeparti,151,2011-09-12,3,0.666539485553341,1,3,2
kandidat000869,Ingrid Eide,2007,ap,18,12,Valgt,1199,74,81265,29.89,Det norske Arbeiderparti,1273,2007-09-10,251,5.90974617537869,17,388,371
kandidat000870,Ingrid Elise Wergeland,2007,sp,10,7,Ikke valgt,39,7,2189,0.81,Senterpartiet,46,2007-09-10,15,1.05505348637847,5,45,40
kandidat000871,Ingrid Elise Wergeland,2011,sp,56,52,Ikke valgt,4,1,1591,0.51,Senterpartiet,5,2011-09-12,18,0.00465769059110655,0,63,63
kandidat000872,Ingrid Espelid Hovig,2007,v,17,42,Ikke valgt,361,44,23703,8.72,Venstre,405,2007-09-10,989,29.9564137948283,75,3255,3180
kandidat000873,Ingrid Marie Mikelsen,2015,mdg,42,41,Ikke valgt,141,14,26096,8.14,Miljøpartiet De Grønne,155,2015-09-14,5,0.000130126955927367,0,9,9
kandidat000874,Ingrid Schei,2011,mdg,44,38,Ikke valgt,36,2,7653,2.47,Miljøpartiet De Grønne,38,2011-09-12,8,0.691813202096862,2,30,28
kandidat000875,Ingrid Schei,2015,mdg,36,39,Ikke valgt,191,10,26096,8.14,Miljøpartiet De Grønne,201,2015-09-14,35,6.80698686886115,23,65,42
kandidat000876,Ingunn Ikdahl,2015,v,45,36,Ikke valgt,111,8,21986,6.86,Venstre,119,2015-09-14,7,0.000195021945937733,0,29,29
kandidat000877,Ingunn Norderval,2007,ap,35,20,Vara,623,22,81265,29.89,Det norske Arbeiderparti,645,2007-09-10,11,0.000579681239783707,0,35,35
kandidat000878,Ingvar Botnen,2007,sp,28,15,Ikke valgt,15,4,2189,0.81,Senterpartiet,19,2007-09-10,7,0.962821886279867,1,10,9
kandidat000879,Ingvar Botnen,2011,sp,42,24,Ikke valgt,8,1,1591,0.51,Senterpartiet,9,2011-09-12,18,0.0272754692073725,0,28,28
kandidat000880,Ingvar Botnen,2015,sp,27,25,Ikke valgt,22,0,1926,0.6,Senterpartiet,22,2015-09-14,6,0.0391747378883363,0,34,34
kandidat000881,Ingvarda Andreassen,2011,dem,27,19,Ikke valgt,1,0,214000,0.07,Demokratene i Norge,1,NA,0,0,0,0,0
kandidat000882,Ingvil As,2007,rv,45,38,Ikke valgt,45,5,14131,5.2,Rød Valgallianse,50,NA,0,0,0,0,0
kandidat000883,Ingvild Hedemann Rishøi,2015,mdg,30,65,Ikke valgt,223,27,26096,8.14,Miljøpartiet De Grønne,250,2015-09-14,37,1.98802547495361,3,81,78
kandidat000884,Ingvild Reymert,2011,sv,3,5,Valgt,1058,219,19477,6.28,Sosialistisk Venstreparti,1277,2011-09-12,1275,5.02361549316485,7,1280,1273
kandidat000885,Ingvill Elvestad Meltvedt,2015,v,35,44,Ikke valgt,121,21,21986,6.86,Venstre,142,NA,0,0,0,0,0
kandidat000886,Ingvill Stapnes Elvestad,2011,v,11,10,Vara,330,64,25351,8.17,Venstre,394,2011-09-12,5,5.30707291151989e-07,0,6,6
kandidat000887,Ingvill Størksen,2011,sp,6,11,Ikke valgt,29,33,1591,0.51,Senterpartiet,62,2011-09-12,12,3.19417392120588,6,24,18
kandidat000888,Ingvil Tybring-Gjedde,2011,frp,11,13,Vara,456,29,21852,7.04,Fremskrittspartiet,485,2011-09-12,4,0.0480797338240868,0,4,4
kandidat000889,Irene Reinskou,2007,v,61,52,Ikke valgt,89,1,23703,8.72,Venstre,90,2007-09-10,4,5.1893729176885e-13,0,6,6
kandidat000890,Iren Mari Luther,2011,sv,52,56,Ikke valgt,74,6,19477,6.28,Sosialistisk Venstreparti,80,2011-09-12,2,1.50495231991232,2,2,0
kandidat000891,Iren Mari Luther,2015,sv,48,47,Ikke valgt,110,6,17445,5.44,Sosialistisk Venstreparti,116,2015-09-14,8,1.72239096129827,2,10,8
kandidat000892,Irma Iversen,2007,h,43,36,Ikke valgt,294,5,68475,25.19,Høyre,299,2007-09-10,163,3.15927266625668,4,216,212
kandidat000893,Irma Iversen,2015,h,64,42,Ikke valgt,247,11,101882,31.8,Høyre,258,2015-09-14,9,0.0243086977587951,0,265,265
kandidat000894,Isa Maline Alstadius Isene,2015,mdg,39,47,Ikke valgt,170,12,26096,8.14,Miljøpartiet De Grønne,182,2015-09-14,10,1.83326452007088,2,10,8
kandidat000895,Ismail Ali Ahmed,2011,sv,11,26,Vara,382,46,19477,6.28,Sosialistisk Venstreparti,428,2011-09-12,2,0.0522201576949067,0,3,3
kandidat000896,Ismet Kaga,2007,ap,33,33,Vara,655,31,81265,29.89,Det norske Arbeiderparti,686,2007-09-10,3,2.28277477128562,3,9,6
kandidat000897,Ivar Christiansen,2007,ap,24,29,Vara,928,33,81265,29.89,Det norske Arbeiderparti,961,2007-09-10,533,47.7599158776926,134,1244,1110
kandidat000898,Ivar Christiansen,2011,ap,41,26,Vara,650,20,102707,33.1,Det norske Arbeiderparti,670,2011-09-12,2180,31.4165969947202,131,3424,3293
kandidat000899,Ivar Dyb Kraglund,2011,krf,50,40,Ikke valgt,30,2,7571,2.44,Kristelig Folkeparti,32,2011-09-12,2,1.55293576364748,2,2,0
kandidat000900,Ivar Glomstein,2007,h,15,30,Valgt,1215,37,68475,25.19,Høyre,1252,2007-09-10,10,0.679491467753508,1,58,57
kandidat000901,Ivar Johansen,2007,sv,4,9,Valgt,963,278,28701,10.56,Sosialistisk Venstreparti,1241,2007-09-10,1226,46.7679708152695,111,4134,4023
kandidat000902,Ivar Johansen,2011,sv,2,6,Valgt,976,552,19477,6.28,Sosialistisk Venstreparti,1528,2011-09-12,1977,33.8908057099719,52,6111,6059
kandidat000903,Ivar Johansen,2015,sv,2,8,Valgt,1254,1286,17445,5.44,Sosialistisk Venstreparti,2540,2015-09-14,2549,51.8898796474624,122,8660,8538
kandidat000904,Iver Aastebøl,2011,rv,18,16,Ikke valgt,167,32,11257,3.63,Rødt,199,2011-09-12,520,16.3756873894131,29,523,494
kandidat000905,Iver B Neumann,2007,osby,16,48,Ikke valgt,22,14,1466,0.54,Oslo Byaksjon,36,2007-09-10,320,6.95578161394934,17,553,536
kandidat000906,Jack A. Martinussen,2007,dem,42,9,Ikke valgt,0,0,306000,0.11,Demokratene,0,2007-09-10,2,0.00535734535648915,0,2,2
kandidat000907,Jack Grimsrud,2007,ap,32,23,Vara,681,29,81265,29.89,Det norske Arbeiderparti,710,2007-09-10,91,6.15372989511246,14,103,89
kandidat000908,Jack Herheim,2007,mdg,19,13,Ikke valgt,20,7,1687,0.62,Miljøpartiet De Grønne,27,2007-09-10,9,0.956304418592525,3,13,10
kandidat000909,Jakob Bastesen,2007,kp,8,10,Ikke valgt,5,1,120000,0.04,Kystpartiet,6,NA,0,0,0,0,0
kandidat000910,Jakob Pedersen Nygård,2011,rv,38,34,Ikke valgt,67,5,11257,3.63,Rødt,72,2011-09-12,23,0.80374952545566,0,24,24
kandidat000911,James Stove Lorentzen,2011,h,15,37,Valgt,1252,37,110776,35.7,Høyre,1289,2011-09-12,65,2.79913396298951,3,236,233
kandidat000912,James Stove Lorentzen,2015,h,14,16,Valgt,1677,50,101882,31.8,Høyre,1727,2015-09-14,255,7.96024229138317,15,491,476
kandidat000913,Jan Aage Hansen,2007,dem,48,30,Ikke valgt,0,0,306000,0.11,Demokratene,0,2007-09-10,1,7.17624592684045e-15,0,21,21
kandidat000914,Jan Arild Linja,2007,frp,19,30,Vara,235,4,38873,14.3,Fremskrittspartiet,239,2007-09-10,13,0.379793082329264,2,15,13
kandidat000915,Jan Arild Linja,2015,frp,12,16,Ikke valgt,259,21,19311,6.03,Fremskrittspartiet,280,2015-09-14,46,8.33451579725445,10,108,98
kandidat000916,Jan-Arild Linja,2011,frp,22,38,Ikke valgt,142,9,21852,7.04,Fremskrittspartiet,151,2011-09-12,47,4.92915583597746,7,62,55
kandidat000917,Jan-Arne Frantzen,2007,frp,33,19,Ikke valgt,163,1,38873,14.3,Fremskrittspartiet,164,2007-09-10,9,0.207664176159802,1,9,8
kandidat000918,Jan Christian Vestre,2011,ap,45,52,Ikke valgt,556,14,102707,33.1,Det norske Arbeiderparti,570,2011-09-12,30,0.10419248471989,0,795,795
kandidat000919,Jan Eggum,2007,mdg,18,61,Ikke valgt,21,7,1687,0.62,Miljøpartiet De Grønne,28,2007-09-10,2940,98.6903892067753,253,7026,6773
kandidat000920,Jan E. Grindheim,2007,osby,22,14,Ikke valgt,16,12,1466,0.54,Oslo Byaksjon,28,NA,0,0,0,0,0
kandidat000921,Jane Helen Johansen,2015,mdg,54,55,Ikke valgt,121,5,26096,8.14,Miljøpartiet De Grønne,126,2015-09-14,3,0.000450568711912456,0,39,39
kandidat000922,Jan-Erik Kristiansen,2007,frp,36,37,Ikke valgt,156,3,38873,14.3,Fremskrittspartiet,159,2007-09-10,98,3.73528572332799,8,299,291
kandidat000923,Jan Erik Øvergaard,2011,pp,20,20,Ikke valgt,10,1,1045,0.34,Pensjonistpartiet,11,NA,0,0,0,0,0
kandidat000924,Jan Erik Vold,2007,rv,12,64,Ikke valgt,361,49,14131,5.2,Rød Valgallianse,410,2007-09-10,2182,44.055443938038,131,4826,4695
kandidat000925,Jan Fredrik Sundene,2011,pp,13,7,Ikke valgt,14,1,1045,0.34,Pensjonistpartiet,15,NA,0,0,0,0,0
kandidat000926,Jan Fredrik Sundene,2015,pp,16,4,Ikke valgt,13,4,1169,0.36,Pensjonistpartiet,17,NA,0,0,0,0,0
kandidat000927,Janicke Knudtzon,2007,dem,14,12,Ikke valgt,3,2,306000,0.11,Demokratene,5,2007-09-10,2,1.78273228781366,2,2,0
kandidat000928,Jan Joar Tranøy Jenvild,2007,kp,16,22,Ikke valgt,3,0,120000,0.04,Kystpartiet,3,NA,0,0,0,0,0
kandidat000929,Jan Mesicek,2011,v,48,50,Ikke valgt,76,13,25351,8.17,Venstre,89,2011-09-12,48,1.72121993677488,2,113,111
kandidat000930,Janne Petra Thørn,2007,frp,28,24,Ikke valgt,184,3,38873,14.3,Fremskrittspartiet,187,2007-09-10,8,0.912107329389642,1,11,10
kandidat000931,Janne Stang Dahl,2007,osby,27,39,Ikke valgt,16,9,1466,0.54,Oslo Byaksjon,25,2007-09-10,32,1.49936248663443,2,38,36
kandidat000932,Janne Svegården,2007,ap,8,10,Valgt,1543,60,81265,29.89,Det norske Arbeiderparti,1603,2007-09-10,62,2.39390788595821,4,81,77
kandidat000933,Jan Ø. Jahnsen,2011,dem,11,15,Ikke valgt,6,1,214000,0.07,Demokratene i Norge,7,NA,0,0,0,0,0
kandidat000934,Jan Olav Aamlid,2007,kp,19,48,Ikke valgt,3,0,120000,0.04,Kystpartiet,3,2007-09-10,8,0.190935055173339,1,187,186
kandidat000935,Jan Olav Aamlid,2015,kp,10,18,Ikke valgt,7,1,124,0.04,Kystpartiet,8,2015-09-14,12,0.358244840015118,2,206,204
kandidat000936,Jan Olav Andersen,2011,sv,56,40,Ikke valgt,59,5,19477,6.28,Sosialistisk Venstreparti,64,2011-09-12,698,26.4394644738769,34,1521,1487
kandidat000937,Jan Olav Andersen,2015,sv,54,48,Ikke valgt,59,7,17445,5.44,Sosialistisk Venstreparti,66,2015-09-14,1759,15.8670576152111,46,3280,3234
kandidat000938,Jan Øystein Jahnsen,2007,dem,30,34,Ikke valgt,2,0,306000,0.11,Demokratene,2,NA,0,0,0,0,0
kandidat000939,Jan-Petter Holtedahl,2011,v,57,40,Ikke valgt,57,2,25351,8.17,Venstre,59,2011-09-12,8,0.00305421905809457,0,10,10
kandidat000940,Jan Sigurd Krogh,2007,mdg,64,49,Ikke valgt,2,0,1687,0.62,Miljøpartiet De Grønne,2,NA,0,0,0,0,0
kandidat000941,Jan Tank-Nielsen,2007,frp,12,15,Vara,317,57,38873,14.3,Fremskrittspartiet,374,2007-09-10,46,0.841696729105605,0,59,59
kandidat000942,Jan Tank-Nielsen,2011,frp,12,11,Ikke valgt,231,58,21852,7.04,Fremskrittspartiet,289,2011-09-12,61,0.204869254303655,1,120,119
kandidat000943,Jan Vidar Hansen,2007,frp,21,33,Vara,230,4,38873,14.3,Fremskrittspartiet,234,2007-09-10,12,0.509316310442056,1,27,26
kandidat000944,Jan-Vidar Hansen,2011,frp,49,40,Ikke valgt,66,3,21852,7.04,Fremskrittspartiet,69,2011-09-12,169,1.62017361808342,3,196,193
kandidat000945,Jarand Felland,2007,sp,16,8,Ikke valgt,17,15,2189,0.81,Senterpartiet,32,2007-09-10,7,1.10346205028569,2,17,15
kandidat000946,Jarand Felland,2011,sp,33,14,Ikke valgt,10,2,1591,0.51,Senterpartiet,12,2011-09-12,243,0.189955079649132,1,260,259
kandidat000947,Jarand Rystad,2007,osby,40,19,Ikke valgt,4,9,1466,0.54,Oslo Byaksjon,13,2007-09-10,9,0.940792457724507,2,20,18
kandidat000948,Jarand Ullestad,2011,mdg,24,31,Ikke valgt,50,6,7653,2.47,Miljøpartiet De Grønne,56,2011-09-12,6,0.184552202490432,1,12,11
kandidat000949,Jarle Brunsell,2007,dlf,10,9,Ikke valgt,4,0,127000,0.05,Det Liberale Folkepartiet,4,2007-09-10,3,0.270400031335317,2,7,5
kandidat000950,Jarle Brunsell,2011,dlf,9,6,Ikke valgt,6,0,247000,0.08,Det Liberale Folkepartiet,6,2011-09-12,11,0.00266568335292852,0,18,18
kandidat000951,Jarle Fagerheim,2011,mdg,6,7,Ikke valgt,214,36,7653,2.47,Miljøpartiet De Grønne,250,2011-09-12,82,5.29876177725134,9,125,116
kandidat000952,Jarle Nordby,2011,ap,50,64,Ikke valgt,496,9,102707,33.1,Det norske Arbeiderparti,505,2011-09-12,15,2.03489075244485,2,17,15
kandidat000953,Jarle Rosseland,2007,kp,38,35,Ikke valgt,0,1,120000,0.04,Kystpartiet,1,2007-09-10,135,9.45263536277559,40,256,216
kandidat000954,Jarle Rosseland,2015,kp,14,13,Ikke valgt,3,2,124,0.04,Kystpartiet,5,2015-09-14,215,0.904507926915612,4,663,659
kandidat000955,Jarl W. Alnæs,2007,v,32,20,Ikke valgt,173,28,23703,8.72,Venstre,201,2007-09-10,5,1.75883700880529,2,9,7
kandidat000956,Jarl Wilhelm Alnæs,2011,v,27,20,Ikke valgt,151,27,25351,8.17,Venstre,178,NA,0,0,0,0,0
kandidat000957,Jarl Wilhelm Alnæs,2015,v,27,18,Ikke valgt,148,33,21986,6.86,Venstre,181,2015-09-14,2,1.29228459677284,2,2,0
kandidat000958,Jawad Azadmehr,2015,h,51,62,Ikke valgt,333,46,101882,31.8,Høyre,379,2015-09-14,10,1.16635125192592,2,11,9
kandidat000959,Jenni Pettersen,2007,frp,23,25,Ikke valgt,224,4,38873,14.3,Fremskrittspartiet,228,2007-09-10,1,0.616929823373548,1,1,0
kandidat000960,Jenny Clemet von Tetzschner,2015,h,3,3,Valgt,4228,151,101882,31.8,Høyre,4379,2015-09-14,223,15.3513111120488,28,238,210
kandidat000961,Jenny Jensen,2007,kp,2,4,Ikke valgt,6,8,120000,0.04,Kystpartiet,14,2007-09-10,478,17.5013678547141,48,621,573
kandidat000962,Jenny Karine Sundsbø,2015,sp,46,43,Ikke valgt,10,0,1926,0.6,Senterpartiet,10,NA,0,0,0,0,0
kandidat000963,Jenny Maria Lundgaard,2007,rv,55,52,Ikke valgt,36,1,14131,5.2,Rød Valgallianse,37,2007-09-10,7,7.82972100146802e-06,0,8,8
kandidat000964,Jens Christopher Myhre,2007,ap,36,25,Vara,560,73,81265,29.89,Det norske Arbeiderparti,633,2007-09-10,39,2.09519217860206,5,39,34
kandidat000965,Jens Dedichen,2007,frp,20,23,Vara,203,31,38873,14.3,Fremskrittspartiet,234,2007-09-10,4,3.86640693236563e-07,0,80,80
kandidat000966,Jens Dedichen,2011,frp,28,37,Ikke valgt,86,34,21852,7.04,Fremskrittspartiet,120,2011-09-12,5,0.00983714588265717,0,85,85
kandidat000967,Jens E. Lange,2011,frp,39,50,Ikke valgt,87,7,21852,7.04,Fremskrittspartiet,94,2011-09-12,15,0.505472602023466,1,52,51
kandidat000968,Jens Emil Lange,2007,frp,39,38,Ikke valgt,141,6,38873,14.3,Fremskrittspartiet,147,NA,0,0,0,0,0
kandidat000969,Jens Petter Lunde,2011,v,58,48,Ikke valgt,54,3,25351,8.17,Venstre,57,2011-09-12,88,1.13013347012695,5,173,168
kandidat000970,Joachim Dyrdahl,2015,mdg,64,54,Ikke valgt,77,2,26096,8.14,Miljøpartiet De Grønne,79,2015-09-14,13,0.000710305863726224,0,179,179
kandidat000971,Joakim Dyrnes,2011,sv,41,44,Ikke valgt,119,12,19477,6.28,Sosialistisk Venstreparti,131,2011-09-12,6,3.03751963789502,5,6,1
kandidat000972,Joakim Dyrnes,2015,sv,10,6,Ikke valgt,486,95,17445,5.44,Sosialistisk Venstreparti,581,2015-09-14,43,0.479640553489008,1,49,48
kandidat000973,Joakim Røise,2007,krf,59,53,Ikke valgt,21,2,8368,3.08,Kristelig Folkeparti,23,2007-09-10,3,0.00875617408563533,0,3,3
kandidat000974,Joakim Skajaa,2015,mdg,49,50,Ikke valgt,127,13,26096,8.14,Miljøpartiet De Grønne,140,2015-09-14,99,1.10361801962003,1,137,136
kandidat000975,Joanna Deacon,2007,mdg,8,8,Ikke valgt,68,16,1687,0.62,Miljøpartiet De Grønne,84,2007-09-10,6,1.40278537920522,2,6,4
kandidat000976,Joanna Deacon,2011,mdg,34,26,Ikke valgt,42,3,7653,2.47,Miljøpartiet De Grønne,45,NA,0,0,0,0,0
kandidat000977,Joanna Hvalen,2015,pirat,6,13,Ikke valgt,37,8,805,0.25,Piratpartiet,45,NA,0,0,0,0,0
kandidat000978,Jo Flottorp Ness,2015,pirat,18,20,Ikke valgt,22,2,805,0.25,Piratpartiet,24,2015-09-14,2,1.01482207757897,2,13,11
kandidat000979,Jo Frisch,2011,h,48,26,Ikke valgt,390,14,110776,35.7,Høyre,404,2011-09-12,5,0.0248908598362276,0,229,229
kandidat000980,Johan Hansson Nakken,2007,kp,45,29,Ikke valgt,0,0,120000,0.04,Kystpartiet,0,NA,0,0,0,0,0
kandidat000981,Johan Ludvig Nistad,2007,dem,23,13,Ikke valgt,1,1,306000,0.11,Demokratene,2,NA,0,0,0,0,0
kandidat000982,Johan Ludvig Nistad,2011,dem,25,22,Ikke valgt,2,0,214000,0.07,Demokratene i Norge,2,2011-09-12,2,1.55293576364748,2,2,0
kandidat000983,Johanna Engen,2015,rv,38,30,Ikke valgt,136,5,16174,5.05,Rødt,141,2015-09-14,196,7.99210831069913,21,509,488
kandidat000984,Johannes Lagos,2007,sv,55,42,Ikke valgt,104,0,28701,10.56,Sosialistisk Venstreparti,104,2007-09-10,4,0.20929870733432,1,4,3
kandidat000985,Johannes Roaldstveit,2007,kp,28,34,Ikke valgt,1,1,120000,0.04,Kystpartiet,2,NA,0,0,0,0,0
kandidat000986,John Andre Storebø,2011,sp,12,7,Ikke valgt,32,4,1591,0.51,Senterpartiet,36,2011-09-12,7,2.50323555689554,4,7,3
kandidat000987,John Andre Storebø,2015,sp,21,16,Ikke valgt,26,3,1926,0.6,Senterpartiet,29,2015-09-14,42,1.83640966405143,2,49,47
kandidat000988,John Bjørnøy,2011,v,49,26,Ikke valgt,78,10,25351,8.17,Venstre,88,2011-09-12,38,1.56912638351003,4,74,70
kandidat000989,John Bjørnøy,2015,v,41,24,Ikke valgt,107,18,21986,6.86,Venstre,125,2015-09-14,46,2.05257107512716,3,120,117
kandidat000990,John Hille,2015,mdg,61,48,Ikke valgt,81,6,26096,8.14,Miljøpartiet De Grønne,87,2015-09-14,41,0.875565629685473,1,301,300
kandidat000991,John-Inge Skaardal,2007,krf,57,54,Ikke valgt,24,0,8368,3.08,Kristelig Folkeparti,24,2007-09-10,6,0.000292792223872618,0,22,22
kandidat000992,John Olala Omollo,2011,h,62,44,Ikke valgt,217,16,110776,35.7,Høyre,233,2011-09-12,9,0.982077576389619,1,9,8
kandidat000993,John Peter Tollefsen,2015,h,44,43,Ikke valgt,442,9,101882,31.8,Høyre,451,2015-09-14,97,0.312398982462562,1,655,654
kandidat000994,John Slinning Jannesson,2015,mdg,55,28,Ikke valgt,118,1,26096,8.14,Miljøpartiet De Grønne,119,2015-09-14,12,0.00798659411902582,0,12,12
kandidat000995,John Tore Norenberg,2007,h,29,47,Vara,421,66,68475,25.19,Høyre,487,2007-09-10,95,4.95173339303104,10,603,593
kandidat000996,John Tore Norenberg,2011,h,35,43,Vara,550,29,110776,35.7,Høyre,579,2011-09-12,40,2.66592930005148,3,643,640
kandidat000997,John Vågåsar,2007,pp,18,14,Ikke valgt,11,0,1414,0.52,Pensjonistpartiet,11,NA,0,0,0,0,0
kandidat000998,Johny Oddleif Røst,2015,ksp,15,10,Ikke valgt,8,1,421,0.13,Partiet De Kristne,9,2015-09-14,2,5.74786179844818e-08,0,2,2
kandidat000999,Jokke Fjeldstad,2011,rv,21,12,Ikke valgt,139,18,11257,3.63,Rødt,157,2011-09-12,59,0.906319142348122,2,59,57
kandidat001000,Jokke Netland,2007,rv,31,24,Ikke valgt,87,7,14131,5.2,Rød Valgallianse,94,2007-09-10,16,0.891988347630207,1,16,15
kandidat001001,Jonas Røed,2015,sp,50,39,Ikke valgt,6,1,1926,0.6,Senterpartiet,7,2015-09-14,4,0.00690331118383342,0,7,7
kandidat001002,Jon Christian Brekke,2015,pirat,21,17,Ikke valgt,18,0,805,0.25,Piratpartiet,18,NA,0,0,0,0,0
kandidat001003,Jon Eikemo,2007,sp,9,49,Ikke valgt,41,17,2189,0.81,Senterpartiet,58,2007-09-10,741,32.6396360341461,48,2940,2892
kandidat001004,Jon Eikemo,2011,sp,13,57,Ikke valgt,18,8,1591,0.51,Senterpartiet,26,2011-09-12,1274,8.92826478876463,22,4214,4192
kandidat001005,Jon Håkon Øen,2007,krf,34,62,Ikke valgt,42,1,8368,3.08,Kristelig Folkeparti,43,2007-09-10,13,1.82649372790016,3,14,11
kandidat001006,Jon Hovde Brennekåsa,2007,sp,40,29,Ikke valgt,6,3,2189,0.81,Senterpartiet,9,2007-09-10,1,0.00492712315397501,0,3,3
kandidat001007,Jon Hovde Brennekåsa,2011,sp,37,25,Ikke valgt,10,0,1591,0.51,Senterpartiet,10,2011-09-12,2,0.0030184628406133,0,5,5
kandidat001008,Jon Julius Sandal,2011,v,43,54,Ikke valgt,88,12,25351,8.17,Venstre,100,2011-09-12,35,3.19388409490468,8,35,27
kandidat001009,Jon Julius Sandal,2015,mdg,10,8,Vara,565,160,26096,8.14,Miljøpartiet De Grønne,725,2015-09-14,59,5.13340855094526,10,94,84
kandidat001010,Jon M. Arnesveen,2007,kp,33,8,Ikke valgt,0,1,120000,0.04,Kystpartiet,1,NA,0,0,0,0,0
kandidat001011,Jon Nordenson,2007,ap,20,17,Vara,1036,19,81265,29.89,Det norske Arbeiderparti,1055,2007-09-10,28,0.00111713367251684,0,52,52
kandidat001012,Jonny Arnesen,2007,h,26,12,Vara,549,10,68475,25.19,Høyre,559,2007-09-10,10,1.04962031666278,2,26,24
kandidat001013,Jon Ole Whist,2007,h,33,61,Vara,349,80,68475,25.19,Høyre,429,2007-09-10,57,8.8490658467993,17,61,44
kandidat001014,Jon Ole Whist,2011,h,37,63,Vara,491,59,110776,35.7,Høyre,550,2011-09-12,145,9.18940033799824,19,206,187
kandidat001015,Jon Ole Whist,2015,h,30,27,Vara,616,58,101882,31.8,Høyre,674,2015-09-14,65,11.0168254789691,20,271,251
kandidat001016,Jon Reidar Øyan,2015,ap,30,21,Vara,1385,211,102431,31.97,Arbeiderpartiet,1596,2015-09-14,405,5.05328084396748,13,3537,3524
kandidat001017,Jon-Terje Bekken,2015,v,44,22,Ikke valgt,101,20,21986,6.86,Venstre,121,2015-09-14,83,3.42532883353754,7,174,167
kandidat001018,Jon T. Kvikne,2007,v,47,45,Ikke valgt,117,17,23703,8.72,Venstre,134,2007-09-10,4,1.33618977501324,2,263,261
kandidat001019,Jon Torstein Kvikne,2011,v,65,47,Ikke valgt,40,2,25351,8.17,Venstre,42,2011-09-12,11,0.618658161778191,1,26,25
kandidat001020,Jøran Kallmyr,2007,frp,7,7,Valgt,529,27,38873,14.3,Fremskrittspartiet,556,2007-09-10,255,88.1021071418044,174,264,90
kandidat001021,Jøran Kallmyr,2011,frp,2,4,Valgt,776,119,21852,7.04,Fremskrittspartiet,895,2011-09-12,4194,352.014979086805,629,4458,3829
kandidat001022,Jørgen Foss,2015,ap,37,35,Vara,1191,103,102431,31.97,Arbeiderpartiet,1294,2015-09-14,827,12.213000955449,32,1243,1211
kandidat001023,Jørgen Honningsvåg,2011,krf,27,38,Ikke valgt,77,8,7571,2.44,Kristelig Folkeparti,85,2011-09-12,7,0.144850851921354,0,12,12
kandidat001024,Jørgen Hovde,2011,nkp,1,1,Ikke valgt,29,30,210000,0.07,Norges Kommunistiske Parti,59,2011-09-12,27,5.69011505963879,11,41,30
kandidat001025,Jørgen Kann,2011,mdg,54,45,Ikke valgt,26,2,7653,2.47,Miljøpartiet De Grønne,28,NA,0,0,0,0,0
kandidat001026,Jørgen Strickert,2011,rv,32,40,Ikke valgt,93,8,11257,3.63,Rødt,101,2011-09-12,139,1.77922643037263,2,250,248
kandidat001027,Jørgen Wahlberg,2015,v,58,61,Ikke valgt,78,8,21986,6.86,Venstre,86,2015-09-14,36,1.16238214894469,3,408,405
kandidat001028,Jorge R S Rocabado,2015,rv,62,51,Ikke valgt,57,3,16174,5.05,Rødt,60,NA,0,0,0,0,0
kandidat001029,Jørn Granaas,2007,pp,27,9,Ikke valgt,7,0,1414,0.52,Pensjonistpartiet,7,NA,0,0,0,0,0
kandidat001030,Jørn Kristiansen,2011,ap,44,34,Ikke valgt,560,11,102707,33.1,Det norske Arbeiderparti,571,2011-09-12,400,4.44367688131471,9,1962,1953
kandidat001031,Jørn Mortensen,2007,osby,36,18,Ikke valgt,12,3,1466,0.54,Oslo Byaksjon,15,2007-09-10,150,0.257917913968386,1,253,252
kandidat001032,Jørn Nygren,2011,ap,37,30,Vara,775,7,102707,33.1,Det norske Arbeiderparti,782,2011-09-12,16,1.97964078142946,3,21,18
kandidat001033,Jørn Nygren,2015,ap,36,27,Vara,1334,27,102431,31.97,Arbeiderpartiet,1361,2015-09-14,29,0.00436159072353618,0,50,50
kandidat001034,Jorun Gulbrandsen,2015,rv,29,60,Ikke valgt,160,9,16174,5.05,Rødt,169,2015-09-14,104,1.95188797397888,2,817,815
kandidat001035,Jorun Mai Nyfløt,2007,sp,38,27,Ikke valgt,9,1,2189,0.81,Senterpartiet,10,2007-09-10,4,0.0103291758399651,0,4,4
kandidat001036,Jorun Marie Gulbrandsen,2011,rv,55,42,Ikke valgt,44,1,11257,3.63,Rødt,45,NA,0,0,0,0,0
kandidat001037,Jorunn Folkvord,2007,rv,14,23,Ikke valgt,276,34,14131,5.2,Rød Valgallianse,310,2007-09-10,13,0.107859316089451,0,50,50
kandidat001038,Jorunn Folkvord,2011,rv,13,17,Ikke valgt,407,99,11257,3.63,Rødt,506,2011-09-12,16,0.967006002665759,1,66,65
kandidat001039,Jorunn Folkvord,2015,rv,14,12,Ikke valgt,560,83,16174,5.05,Rødt,643,2015-09-14,28,0.155513659793993,1,94,93
kandidat001040,Jorunn Hæreid,2007,rv,59,54,Ikke valgt,33,1,14131,5.2,Rød Valgallianse,34,NA,0,0,0,0,0
kandidat001041,Jorunn Marie Grønnevik,2007,pp,2,2,Ikke valgt,47,14,1414,0.52,Pensjonistpartiet,61,2007-09-10,1,3.83667539454429e-13,0,1,1
kandidat001042,Jorunn Marie Grønnevik,2011,pp,2,2,Ikke valgt,32,13,1045,0.34,Pensjonistpartiet,45,2011-09-12,1,1.19923127092213e-08,0,2,2
kandidat001043,Jorunn Marie Grønnevik,2015,pp,2,2,Ikke valgt,38,22,1169,0.36,Pensjonistpartiet,60,2015-09-14,2,0.00029536853920323,0,4,4
kandidat001044,Jorun Randi Hermansen,2011,v,62,38,Ikke valgt,45,1,25351,8.17,Venstre,46,NA,0,0,0,0,0
kandidat001045,Joseph B Conteh,2015,ksp,5,5,Ikke valgt,22,5,421,0.13,Partiet De Kristne,27,NA,0,0,0,0,0
kandidat001046,Juan Ernesto Garcia,2007,nkp,6,12,Ikke valgt,10,7,203000,0.07,Norges Kommunistiske Parti,17,NA,0,0,0,0,0
kandidat001047,Judith Kvernes,2015,sv,20,19,Ikke valgt,286,30,17445,5.44,Sosialistisk Venstreparti,316,2015-09-14,11,0.00451545923745102,0,74,74
kandidat001048,Judith Nærland,2007,osby,61,57,Ikke valgt,1,3,1466,0.54,Oslo Byaksjon,4,2007-09-10,8,0.247820681673839,0,14,14
kandidat001049,Julianne Ferskaug,2011,v,7,6,Vara,550,55,25351,8.17,Venstre,605,2011-09-12,11,0.0110271992324596,0,11,11
kandidat001050,Julianne Ferskaug,2015,v,6,5,Vara,710,115,21986,6.86,Venstre,825,2015-09-14,65,6.66697649183514,9,76,67
kandidat001051,Julian Thomas Calvert,2007,krf,16,26,Ikke valgt,81,4,8368,3.08,Kristelig Folkeparti,85,2007-09-10,3,0.267092140237576,1,3,2
kandidat001052,Julie Brodtkorb Voldberg,2011,h,11,62,Valgt,3593,139,110776,35.7,Høyre,3732,2011-09-12,494,22.6405063975828,45,501,456
kandidat001053,Julie Jørgensen,2011,rv,46,51,Ikke valgt,57,3,11257,3.63,Rødt,60,2011-09-12,33,0.940383688462857,1,81,80
kandidat001054,Julie Lødrup,2007,ap,21,28,Vara,971,34,81265,29.89,Det norske Arbeiderparti,1005,2007-09-10,30,0.0147447977302668,0,34,34
kandidat001055,Julie Lødrup,2011,ap,28,27,Vara,946,79,102707,33.1,Det norske Arbeiderparti,1025,2011-09-12,212,2.08389369544438,3,246,243
kandidat001056,Julie Lødrup,2015,ap,8,10,Valgt,2205,109,102431,31.97,Arbeiderpartiet,2314,2015-09-14,305,3.33120069429106,6,551,545
kandidat001057,Julie Midtgarden Remen,2011,h,53,46,Ikke valgt,333,14,110776,35.7,Høyre,347,2011-09-12,61,19.6926405764053,58,61,3
kandidat001058,Julie Mørch,2015,mdg,19,19,Ikke valgt,393,34,26096,8.14,Miljøpartiet De Grønne,427,2015-09-14,9,0.154154793130948,0,11,11
kandidat001059,Julie Ness,2015,mdg,38,59,Ikke valgt,172,12,26096,8.14,Miljøpartiet De Grønne,184,2015-09-14,11,0.363500348628084,1,46,45
kandidat001060,Kaare R Norum,2015,v,46,46,Ikke valgt,104,13,21986,6.86,Venstre,117,2015-09-14,252,0.904105634059324,2,1128,1126
kandidat001061,Kaare R. Norum,2007,v,22,48,Ikke valgt,253,28,23703,8.72,Venstre,281,2007-09-10,284,5.49403283159942,6,741,735
kandidat001062,Kaare R. Norum,2011,v,15,16,Ikke valgt,266,43,25351,8.17,Venstre,309,2011-09-12,135,0.0386902541938929,0,876,876
kandidat001063,Kaia Marie Rosseland,2015,h,46,47,Ikke valgt,392,51,101882,31.8,Høyre,443,2015-09-14,141,0.342036051411406,2,142,140
kandidat001064,Kai Christoffersen,2007,dem,53,48,Ikke valgt,0,0,306000,0.11,Demokratene,0,2007-09-10,2,0.0893673389219208,0,33,33
kandidat001065,Kaisa Celius,2011,rv,20,11,Ikke valgt,155,21,11257,3.63,Rødt,176,2011-09-12,3,1.70542043302993e-05,0,3,3
kandidat001066,Kai Salvesen,2007,mdg,37,33,Ikke valgt,8,2,1687,0.62,Miljøpartiet De Grønne,10,NA,0,0,0,0,0
kandidat001067,Kaja R Wattne,2015,fi,13,23,Ikke valgt,42,6,1388,0.43,Feministisk Initiativ,48,NA,0,0,0,0,0
kandidat001068,Kalle Hesstvedt,2007,sv,58,48,Ikke valgt,77,4,28701,10.56,Sosialistisk Venstreparti,81,2007-09-10,29,1.48034739349611,8,238,230
kandidat001069,Kamil A. Azhar,2007,ap,12,21,Valgt,1611,353,81265,29.89,Det norske Arbeiderparti,1964,2007-09-10,21,0.146419232212668,0,78,78
kandidat001070,Kåre Eriksen,2007,dem,4,5,Ikke valgt,16,5,306000,0.11,Demokratene,21,2007-09-10,173,3.77952478939158,8,564,556
kandidat001071,Kåre Eriksen,2011,dem,1,1,Ikke valgt,29,23,214000,0.07,Demokratene i Norge,52,2011-09-12,392,7.18277181673151,11,956,945
kandidat001072,Kåre Rune Hauge,2011,krf,12,35,Ikke valgt,167,7,7571,2.44,Kristelig Folkeparti,174,2011-09-12,104,0.563600318356404,1,197,196
kandidat001073,Kåre Rune Hauge,2015,krf,16,34,Ikke valgt,132,11,7827,2.44,Kristelig Folkeparti,143,2015-09-14,43,1.65498961261266,3,240,237
kandidat001074,Karianne Hansen Heien,2015,sv,27,25,Ikke valgt,231,6,17445,5.44,Sosialistisk Venstreparti,237,2015-09-14,18,0.0116724496892891,0,21,21
kandidat001075,Kari Celius,2007,rv,48,56,Ikke valgt,40,4,14131,5.2,Rød Valgallianse,44,2007-09-10,4,0.912105297259144,1,8,7
kandidat001076,Kari Celius,2011,rv,42,31,Ikke valgt,63,3,11257,3.63,Rødt,66,NA,0,0,0,0,0
kandidat001077,Kari-Gro Thorstensen,2007,sv,38,58,Ikke valgt,147,8,28701,10.56,Sosialistisk Venstreparti,155,2007-09-10,4,3.52679444130448,4,5,1
kandidat001078,Kari Hagejordet,2007,pp,31,22,Ikke valgt,6,0,1414,0.52,Pensjonistpartiet,6,NA,0,0,0,0,0
kandidat001079,Kari Kjenndalen,2007,ap,51,36,Ikke valgt,373,14,81265,29.89,Det norske Arbeiderparti,387,2007-09-10,83,1.9249959530348,5,199,194
kandidat001080,Karima Abd-Daif,2007,ap,4,4,Valgt,2391,147,81265,29.89,Det norske Arbeiderparti,2538,2007-09-10,165,58.5589160985914,75,179,104
kandidat001081,Karina Hellum,2011,ap,38,29,Vara,686,40,102707,33.1,Det norske Arbeiderparti,726,2011-09-12,44,6.46690565953122,11,46,35
kandidat001082,Karina Hellum,2015,ap,59,52,Ikke valgt,578,14,102431,31.97,Arbeiderpartiet,592,2015-09-14,16,0.00143303390246615,0,62,62
kandidat001083,Karin Barratt,2007,ksp,5,8,Ikke valgt,7,4,158000,0.06,Kristent Samlingsparti,11,NA,0,0,0,0,0
kandidat001084,Karin Beate Theodorsen,2011,sv,35,20,Ikke valgt,148,8,19477,6.28,Sosialistisk Venstreparti,156,2011-09-12,254,0.560080333669654,0,412,412
kandidat001085,Karin Beate Theodorsen,2015,sv,42,45,Ikke valgt,130,10,17445,5.44,Sosialistisk Venstreparti,140,2015-09-14,14,0.0747146752572398,0,426,426
kandidat001086,Karin Eriksson,2015,fi,16,13,Ikke valgt,34,6,1388,0.43,Feministisk Initiativ,40,2015-09-14,27,1.12661076568339,4,105,101
kandidat001087,Karin Haug,2015,pp,8,14,Ikke valgt,19,5,1169,0.36,Pensjonistpartiet,24,2015-09-14,53,1.1604233673697,2,122,120
kandidat001088,Karin Margrethe Aasen,2007,pp,7,10,Ikke valgt,17,3,1414,0.52,Pensjonistpartiet,20,NA,0,0,0,0,0
kandidat001089,Kari Reistadbakk,2007,dem,26,23,Ikke valgt,1,1,306000,0.11,Demokratene,2,NA,0,0,0,0,0
kandidat001090,Kari Rølling,2007,mdg,61,52,Ikke valgt,3,0,1687,0.62,Miljøpartiet De Grønne,3,NA,0,0,0,0,0
kandidat001091,Kari Sjølshagen,2007,nkp,9,4,Ikke valgt,7,4,203000,0.07,Norges Kommunistiske Parti,11,2007-09-10,3,0.00867578520406335,0,12,12
kandidat001092,Kari Skogrand,2007,pp,12,17,Ikke valgt,14,0,1414,0.52,Pensjonistpartiet,14,NA,0,0,0,0,0
kandidat001093,Kari Smedholen,2007,sp,36,32,Ikke valgt,11,1,2189,0.81,Senterpartiet,12,2007-09-10,1,0.00492712315397501,0,1,1
kandidat001094,Karl Jørgen Slette,2007,kp,29,37,Ikke valgt,0,2,120000,0.04,Kystpartiet,2,2007-09-10,1,5.55773861672079e-14,0,7,7
kandidat001095,Karl Jørgen Slette,2011,kp,20,18,Ikke valgt,2,0,126000,0.04,Kystpartiet,2,2011-09-12,3,2.74412762296386e-10,0,10,10
kandidat001096,Karl Jørgen Slette,2015,kp,16,14,Ikke valgt,3,1,124,0.04,Kystpartiet,4,NA,0,0,0,0,0
kandidat001097,Karl Tobias Hansen,2015,ksp,4,4,Ikke valgt,29,2,421,0.13,Partiet De Kristne,31,2015-09-14,1,0.000517241848896628,0,31,31
kandidat001098,Karmjit Grewal,2015,h,29,64,Vara,497,197,101882,31.8,Høyre,694,2015-09-14,3,0.0217700644377077,0,3,3
kandidat001099,Karoline Aspli,2011,frp,26,48,Ikke valgt,119,4,21852,7.04,Fremskrittspartiet,123,2011-09-12,8,2.77313547634829,5,8,3
kandidat001100,Karoline Berthelsen,2011,krf,39,28,Ikke valgt,60,1,7571,2.44,Kristelig Folkeparti,61,2011-09-12,2,0.0522201576949067,0,4,4
kandidat001101,Karoline Berthelsen,2015,krf,14,11,Ikke valgt,135,11,7827,2.44,Kristelig Folkeparti,146,2015-09-14,7,1.54490682578158,2,11,9
kandidat001102,Karoline Bjerkeset,2007,sp,2,2,Ikke valgt,161,71,2189,0.81,Senterpartiet,232,2007-09-10,137,4.59589859192869,11,137,126
kandidat001103,Karoline Grosås Nordbø,2015,krf,27,37,Ikke valgt,102,3,7827,2.44,Kristelig Folkeparti,105,2015-09-14,8,2.54733714644443e-08,0,16,16
kandidat001104,Karoline Marøy,2015,sp,8,9,Ikke valgt,48,22,1926,0.6,Senterpartiet,70,2015-09-14,5,0.277865171795026,1,35,34
kandidat001105,Katarina Storalm,2015,fi,10,11,Ikke valgt,46,15,1388,0.43,Feministisk Initiativ,61,2015-09-14,125,5.00604582323972,17,132,115
kandidat001106,Kate Hege Nielsen,2011,h,38,42,Vara,516,22,110776,35.7,Høyre,538,2011-09-12,9,2.35488023177507,3,25,22
kandidat001107,Kate Hege Nielsen,2015,h,47,51,Ikke valgt,423,18,101882,31.8,Høyre,441,2015-09-14,22,0.150054516731362,1,47,46
kandidat001108,Kathrine Nyhus,2007,osby,5,3,Ikke valgt,84,66,1466,0.54,Oslo Byaksjon,150,2007-09-10,76,8.63375177422449,17,82,65
kandidat001109,Katinka Greve Leiner,2011,ap,27,13,Vara,1038,46,102707,33.1,Det norske Arbeiderparti,1084,2011-09-12,272,1.38072326514175,3,330,327
kandidat001110,Katrine Francesca Amriati,2007,mdg,22,22,Ikke valgt,24,2,1687,0.62,Miljøpartiet De Grønne,26,NA,0,0,0,0,0
kandidat001111,Katrine Kveset Ekeland,2007,nkp,15,8,Ikke valgt,6,2,203000,0.07,Norges Kommunistiske Parti,8,NA,0,0,0,0,0
kandidat001112,Katrine Kveset Ekeland,2011,nkp,3,4,Ikke valgt,19,4,210000,0.07,Norges Kommunistiske Parti,23,NA,0,0,0,0,0
kandidat001113,Katrine Ore,2015,ap,45,30,Ikke valgt,856,18,102431,31.97,Arbeiderpartiet,874,2015-09-14,40,2.90263607256152,5,46,41
kandidat001114,Katrine Selsø,2011,mdg,33,20,Ikke valgt,42,3,7653,2.47,Miljøpartiet De Grønne,45,2011-09-12,1,0.000401621682803358,0,1,1
kandidat001115,Kaveh Ataei,2011,sv,7,8,Vara,594,115,19477,6.28,Sosialistisk Venstreparti,709,2011-09-12,18,1.14975166573833,2,55,53
kandidat001116,Kay Asbjørn Schjørlien,2011,sv,27,18,Ikke valgt,189,22,19477,6.28,Sosialistisk Venstreparti,211,2011-09-12,4,0.000554191680510184,0,9,9
kandidat001117,Ken-Gjøran Johansen,2007,dlf,13,11,Ikke valgt,2,0,127000,0.05,Det Liberale Folkepartiet,2,NA,0,0,0,0,0
kandidat001118,Ken-Gjøran Johansen,2011,dlf,7,5,Ikke valgt,7,0,247000,0.08,Det Liberale Folkepartiet,7,NA,0,0,0,0,0
kandidat001119,Kenneth Berg,2011,sv,36,34,Ikke valgt,137,15,19477,6.28,Sosialistisk Venstreparti,152,2011-09-12,337,12.3026364594927,22,442,420
kandidat001120,Kenneth Christensen,2007,dem,35,49,Ikke valgt,1,1,306000,0.11,Demokratene,2,2007-09-10,55,0.0821315676451276,0,59,59
kandidat001121,Kenneth Eriksen,2015,h,24,63,Vara,727,141,101882,31.8,Høyre,868,2015-09-14,326,12.0417863508552,23,798,775
kandidat001122,Kenneth Rockers,2015,pirat,9,14,Ikke valgt,30,8,805,0.25,Piratpartiet,38,2015-09-14,4,6.53173011232858e-05,0,5,5
kandidat001123,Kent Andersen,2011,frp,20,22,Ikke valgt,137,15,21852,7.04,Fremskrittspartiet,152,2011-09-12,494,65.6312444569408,140,632,492
kandidat001124,Kent Andersen,2015,frp,16,12,Ikke valgt,209,12,19311,6.03,Fremskrittspartiet,221,2015-09-14,474,6.02021223794643,15,1106,1091
kandidat001125,Ketil Vestrum Einarsen,2015,v,61,60,Ikke valgt,61,10,21986,6.86,Venstre,71,2015-09-14,13,0.219152183935169,2,26,24
kandidat001126,Khadan Nafstad,2011,sp,53,45,Ikke valgt,4,1,1591,0.51,Senterpartiet,5,2011-09-12,4,0.0542841918616549,0,4,4
kandidat001127,Khadija Ehsan,2015,v,15,27,Ikke valgt,285,31,21986,6.86,Venstre,316,NA,0,0,0,0,0
kandidat001128,Khalid Mahmood,2007,ap,3,9,Valgt,3044,306,81265,29.89,Det norske Arbeiderparti,3350,2007-09-10,839,14.3147795495756,26,1433,1407
kandidat001129,Khalid Mahmood,2011,ap,12,65,Valgt,3296,66,102707,33.1,Det norske Arbeiderparti,3362,2011-09-12,900,6.22580397736254,11,2333,2322
kandidat001130,Khalid Mahmood,2015,ap,16,43,Valgt,3577,75,102431,31.97,Arbeiderpartiet,3652,2015-09-14,284,2.47351635582131,3,2617,2614
kandidat001131,Khalid Saeed,2007,v,24,54,Ikke valgt,229,28,23703,8.72,Venstre,257,2007-09-10,5,0.536347538181086,2,21,19
kandidat001132,Khamshajiny Gunaratnam,2007,ap,11,44,Valgt,2085,38,81265,29.89,Det norske Arbeiderparti,2123,2007-09-10,57,2.57356023498204,4,57,53
kandidat001133,Khamshajiny Gunaratnam,2011,ap,13,11,Valgt,2505,178,102707,33.1,Det norske Arbeiderparti,2683,2011-09-12,305,20.9753125571828,51,362,311
kandidat001134,Khamshajiny Gunaratnam,2015,ap,3,6,Valgt,3828,203,102431,31.97,Arbeiderpartiet,4031,2015-09-14,608,8.649311661389,14,970,956
kandidat001135,Kim Andre Næss,2007,da,3,3,Ikke valgt,17,10,191000,0.07,Demokratisk Alternativ for Oslo,27,2007-09-10,1,5.78935632873066e-12,0,6,6
kandidat001136,Kim Elvegård,2007,dem,44,19,Ikke valgt,0,0,306000,0.11,Demokratene,0,2007-09-10,1,0.00045056869789003,0,1,1
kandidat001137,Kim Hartvig Gundersen,2007,sp,30,13,Ikke valgt,13,3,2189,0.81,Senterpartiet,16,NA,0,0,0,0,0
kandidat001138,Kirsten Fougner,2007,krf,15,31,Ikke valgt,81,11,8368,3.08,Kristelig Folkeparti,92,2007-09-10,6,1.48311992445468,2,24,22
kandidat001139,Kirsten Sogge,2007,h,47,53,Ikke valgt,240,5,68475,25.19,Høyre,245,NA,0,0,0,0,0
kandidat001140,Kjartan Almenning,2007,v,30,19,Ikke valgt,190,14,23703,8.72,Venstre,204,2007-09-10,16,0.691156435302612,1,17,16
kandidat001141,Kjartan Almenning,2011,v,24,18,Ikke valgt,174,26,25351,8.17,Venstre,200,2011-09-12,143,1.91358536758945,5,160,155
kandidat001142,Kjell Aksum,2007,sv,39,19,Ikke valgt,144,10,28701,10.56,Sosialistisk Venstreparti,154,2007-09-10,4,0.000297896132426571,0,8,8
kandidat001143,Kjell Andreas Grønnevik,2007,pp,3,3,Ikke valgt,39,4,1414,0.52,Pensjonistpartiet,43,2007-09-10,2,4.87777225061895e-08,0,2,2
kandidat001144,Kjell Andreas Grønnevik,2011,pp,4,3,Ikke valgt,27,7,1045,0.34,Pensjonistpartiet,34,2011-09-12,1,1.19923127092213e-08,0,3,3
kandidat001145,Kjell Benum,2007,mdg,48,47,Ikke valgt,6,1,1687,0.62,Miljøpartiet De Grønne,7,NA,0,0,0,0,0
kandidat001146,Kjellbjørn Møller,2007,ksp,4,4,Ikke valgt,8,4,158000,0.06,Kristent Samlingsparti,12,NA,0,0,0,0,0
kandidat001147,Kjell Dahle,2007,sp,26,20,Ikke valgt,17,3,2189,0.81,Senterpartiet,20,2007-09-10,655,10.7106390610101,15,1156,1141
kandidat001148,Kjell Dahle,2011,sp,28,26,Ikke valgt,9,5,1591,0.51,Senterpartiet,14,2011-09-12,267,3.33854673816934,9,1423,1414
kandidat001149,Kjell Dahle,2015,sp,30,29,Ikke valgt,17,3,1926,0.6,Senterpartiet,20,2015-09-14,593,14.9954924856957,38,2016,1978
kandidat001150,Kjell Danielsen,2011,pp,27,29,Ikke valgt,7,2,1045,0.34,Pensjonistpartiet,9,2011-09-12,118,1.13066784806572,2,205,203
kandidat001151,Kjell Danielsen,2015,pp,10,10,Ikke valgt,17,5,1169,0.36,Pensjonistpartiet,22,2015-09-14,91,3.76036465893209,6,296,290
kandidat001152,Kjell Johansen,2007,frp,43,35,Ikke valgt,128,5,38873,14.3,Fremskrittspartiet,133,2007-09-10,906,57.3205952905698,177,1960,1783
kandidat001153,Kjell Johansen,2011,frp,17,17,Ikke valgt,156,12,21852,7.04,Fremskrittspartiet,168,2011-09-12,1850,35.1705470250115,71,3810,3739
kandidat001154,Kjell Johansen,2015,frp,31,32,Ikke valgt,105,15,19311,6.03,Fremskrittspartiet,120,2015-09-14,1868,46.2744245503209,106,5678,5572
kandidat001155,Kjell Magne Veivåg,2011,v,29,65,Ikke valgt,141,28,25351,8.17,Venstre,169,2011-09-12,13,0.977262590080544,1,22,21
kandidat001156,Kjell Omdal Erichsen,2007,h,38,21,Ikke valgt,387,14,68475,25.19,Høyre,401,2007-09-10,3,2.58350575474627,3,3,0
kandidat001157,Kjell Omdal Erichsen,2011,h,50,23,Ikke valgt,368,19,110776,35.7,Høyre,387,2011-09-12,34,1.71741055844611,3,37,34
kandidat001158,Kjell Omdal Erichsen,2015,h,62,33,Ikke valgt,272,18,101882,31.8,Høyre,290,2015-09-14,23,2.12479606629085,3,60,57
kandidat001159,Kjell Rendum,2007,kp,27,33,Ikke valgt,2,0,120000,0.04,Kystpartiet,2,NA,0,0,0,0,0
kandidat001160,Kjell Rendum,2015,kp,12,12,Ikke valgt,5,1,124,0.04,Kystpartiet,6,NA,0,0,0,0,0
kandidat001161,Kjell Stensson,2015,pp,20,15,Ikke valgt,8,2,1169,0.36,Pensjonistpartiet,10,2015-09-14,5,0.0219717026254949,0,14,14
kandidat001162,Kjell Veivåg,2007,v,5,3,Valgt,1002,191,23703,8.72,Venstre,1193,2007-09-10,364,135.401728081445,176,1050,874
kandidat001163,Kjell Veivåg,2015,v,48,65,Ikke valgt,99,17,21986,6.86,Venstre,116,2015-09-14,246,2.65339705600685,3,2630,2627
kandidat001164,Kjetil Aalerud,2007,dem,18,24,Ikke valgt,3,1,306000,0.11,Demokratene,4,2007-09-10,1,3.27458551874678e-14,0,1,1
kandidat001165,Kjetil Braut Simonsen,2007,da,5,5,Ikke valgt,14,5,191000,0.07,Demokratisk Alternativ for Oslo,19,2007-09-10,1,9.21830611290832e-14,0,1,1
kandidat001166,Kjetil Hetland,2007,sp,24,25,Ikke valgt,13,8,2189,0.81,Senterpartiet,21,2007-09-10,3,0.0279331283883512,0,8,8
kandidat001167,Kjetil Hetland,2011,sp,39,36,Ikke valgt,8,2,1591,0.51,Senterpartiet,10,2011-09-12,7,0.00301846298644237,0,15,15
kandidat001168,Kjetil Hetland,2015,sp,29,46,Ikke valgt,17,4,1926,0.6,Senterpartiet,21,2015-09-14,6,0.0562769180055898,0,21,21
kandidat001169,Kjetil Ottar Eritzland,2011,v,53,32,Ikke valgt,75,4,25351,8.17,Venstre,79,NA,0,0,0,0,0
kandidat001170,Klara Lie,2007,krf,18,43,Ikke valgt,69,11,8368,3.08,Kristelig Folkeparti,80,2007-09-10,9,1.35848232539812,7,51,44
kandidat001171,Klaus Stafto,2007,mdg,65,53,Ikke valgt,1,0,1687,0.62,Miljøpartiet De Grønne,1,2007-09-10,5,0.0006975056482254,0,10,10
kandidat001172,Klaus Stafto,2011,mdg,23,23,Ikke valgt,50,10,7653,2.47,Miljøpartiet De Grønne,60,2011-09-12,10,0.0132575709860099,0,20,20
kandidat001173,Knut Elgsaas,2007,ap,47,35,Ikke valgt,423,18,81265,29.89,Det norske Arbeiderparti,441,2007-09-10,45,3.68170425761465,8,113,105
kandidat001174,Knut Enebakk,2011,ksp,6,7,Ikke valgt,13,3,235000,0.08,Kristent Samlingsparti,16,NA,0,0,0,0,0
kandidat001175,Knut Erik Thomassen,2007,pp,8,11,Ikke valgt,15,5,1414,0.52,Pensjonistpartiet,20,2007-09-10,2,0.00385924333235057,0,39,39
kandidat001176,Knut Even Lindsjørn,2007,sv,3,1,Valgt,1984,457,28701,10.56,Sosialistisk Venstreparti,2441,2007-09-10,1054,292.092435649908,469,1351,882
kandidat001177,Knut Falchenberg,2007,h,36,22,Ikke valgt,394,9,68475,25.19,Høyre,403,2007-09-10,42,0.940547253256423,1,442,441
kandidat001178,Knut Falchenberg,2015,h,52,48,Ikke valgt,345,23,101882,31.8,Høyre,368,2015-09-14,35,0.698071982369307,3,740,737
kandidat001179,Knut Falk Qvigstad,2011,mdg,13,11,Ikke valgt,94,16,7653,2.47,Miljøpartiet De Grønne,110,2011-09-12,5,0.624677976161228,1,5,4
kandidat001180,Knut Felberg,2007,osby,45,20,Ikke valgt,6,4,1466,0.54,Oslo Byaksjon,10,2007-09-10,51,1.57100458062477,2,77,75
kandidat001181,Knut Frederik Horn,2015,mdg,50,38,Ikke valgt,116,23,26096,8.14,Miljøpartiet De Grønne,139,2015-09-14,6,0.0980154765126179,1,21,20
kandidat001182,Knut Gardbu,2007,h,44,27,Ikke valgt,293,1,68475,25.19,Høyre,294,2007-09-10,2,0.233946672800945,1,9,8
kandidat001183,Knut Hartmann Olsen,2007,nkp,1,1,Ikke valgt,26,36,203000,0.07,Norges Kommunistiske Parti,62,2007-09-10,2,2.17399009820026e-10,0,5,5
kandidat001184,Knut Hedemann,2011,ap,56,50,Ikke valgt,393,14,102707,33.1,Det norske Arbeiderparti,407,2011-09-12,90,5.55327437492359,8,202,194
kandidat001185,Knut H. Frølich,2007,osby,54,33,Ikke valgt,4,3,1466,0.54,Oslo Byaksjon,7,2007-09-10,5,5.12365271381204e-06,0,8,8
kandidat001186,Knut Johan Øen,2007,mdg,51,31,Ikke valgt,5,1,1687,0.62,Miljøpartiet De Grønne,6,NA,0,0,0,0,0
kandidat001187,Knut Jørgen Justad,2007,kp,43,23,Ikke valgt,0,0,120000,0.04,Kystpartiet,0,NA,0,0,0,0,0
kandidat001188,Knut Kjeldstadli,2015,sv,28,50,Ikke valgt,191,42,17445,5.44,Sosialistisk Venstreparti,233,2015-09-14,525,13.3819402207051,58,1611,1553
kandidat001189,Knut Mønnesland,2007,dlf,3,8,Ikke valgt,7,2,127000,0.05,Det Liberale Folkepartiet,9,NA,0,0,0,0,0
kandidat001190,Knut Nærum,2011,rv,12,62,Ikke valgt,596,159,11257,3.63,Rødt,755,2011-09-12,3606,84.1874518707199,222,6613,6391
kandidat001191,Knut-Olaf Skarvang,2007,frp,26,20,Ikke valgt,190,13,38873,14.3,Fremskrittspartiet,203,2007-09-10,7,1.07351121689168,2,8,6
kandidat001192,Knut Riis,2007,frp,46,45,Ikke valgt,110,2,38873,14.3,Fremskrittspartiet,112,2007-09-10,12,0.56080371443334,1,30,29
kandidat001193,Knut Robøle,2015,krf,50,46,Ikke valgt,24,4,7827,2.44,Kristelig Folkeparti,28,2015-09-14,21,0.083588471385513,0,67,67
kandidat001194,Knut Roger Andersen,2007,ap,25,45,Vara,830,75,81265,29.89,Det norske Arbeiderparti,905,2007-09-10,195,18.5358613236963,37,537,500
kandidat001195,Knut Rustand,2007,frp,35,28,Ikke valgt,156,4,38873,14.3,Fremskrittspartiet,160,2007-09-10,5,0.0701417685525322,0,43,43
kandidat001196,Knut Sand Bakken,2007,ap,48,41,Ikke valgt,397,34,81265,29.89,Det norske Arbeiderparti,431,2007-09-10,171,7.83850124593592,24,358,334
kandidat001197,Konrad Janusz Værnes,2015,h,34,30,Vara,544,43,101882,31.8,Høyre,587,2015-09-14,10,0.0143627820925829,0,10,10
kandidat001198,Kristen Knudsen,2011,v,64,44,Ikke valgt,44,1,25351,8.17,Venstre,45,2011-09-12,16,0.00190727682181216,0,135,135
kandidat001199,Kristen Turtum,2007,kp,9,44,Ikke valgt,2,4,120000,0.04,Kystpartiet,6,NA,0,0,0,0,0
kandidat001200,Krister Borge,2015,pirat,15,19,Ikke valgt,24,2,805,0.25,Piratpartiet,26,2015-09-14,4,7.11889662847111e-06,0,4,4
kandidat001201,Kristian August Moen,2007,dem,41,51,Ikke valgt,1,0,306000,0.11,Demokratene,1,2007-09-10,3,4.49290345887879e-05,0,3,3
kandidat001202,Kristian Norheim,2007,frp,10,9,Vara,477,36,38873,14.3,Fremskrittspartiet,513,2007-09-10,336,25.37637332702,53,356,303
kandidat001203,Kristian Norheim,2011,frp,29,29,Ikke valgt,106,12,21852,7.04,Fremskrittspartiet,118,2011-09-12,163,3.84605931842325,6,519,513
kandidat001204,Kristian Vårvik,2007,sp,22,16,Ikke valgt,20,3,2189,0.81,Senterpartiet,23,2007-09-10,15,0.038027215074564,0,29,29
kandidat001205,Kristian Vårvik,2011,sp,17,10,Ikke valgt,17,2,1591,0.51,Senterpartiet,19,2011-09-12,56,3.5746496235389,7,85,78
kandidat001206,Kristian Vårvik,2015,sp,43,44,Ikke valgt,12,1,1926,0.6,Senterpartiet,13,2015-09-14,109,2.94624793684354,8,194,186
kandidat001207,Kristina Alnes,2011,mdg,40,44,Ikke valgt,34,6,7653,2.47,Miljøpartiet De Grønne,40,2011-09-12,251,12.1335159270125,61,251,190
kandidat001208,Kristin Borg,2015,sv,47,35,Ikke valgt,116,7,17445,5.44,Sosialistisk Venstreparti,123,2015-09-14,55,6.03653925203161,15,113,98
kandidat001209,Kristine Joy Nordenson,2007,ap,43,38,Ikke valgt,490,9,81265,29.89,Det norske Arbeiderparti,499,2007-09-10,1,0.031745636378068,0,3,3
kandidat001210,Kristine Schøyen Berdal,2015,mdg,29,29,Ikke valgt,249,14,26096,8.14,Miljøpartiet De Grønne,263,2015-09-14,24,0.0342401539996613,0,24,24
kandidat001211,Kristin Høimyr,2007,ksp,3,3,Ikke valgt,15,7,158000,0.06,Kristent Samlingsparti,22,NA,0,0,0,0,0
kandidat001212,Kristin Langeland,2015,h,63,60,Ikke valgt,272,4,101882,31.8,Høyre,276,2015-09-14,279,10.6278908112209,28,608,580
kandidat001213,Kristin Vik,2015,h,36,50,Vara,515,41,101882,31.8,Høyre,556,2015-09-14,296,7.73738710411523,17,549,532
kandidat001214,Kristin Vinje,2007,h,7,10,Valgt,1449,84,68475,25.19,Høyre,1533,2007-09-10,80,3.44213922603878,7,102,95
kandidat001215,Kristin Vinje,2011,h,4,3,Valgt,2070,90,110776,35.7,Høyre,2160,2011-09-12,1030,43.6757551033529,75,1132,1057
kandidat001216,Kristoffer Gustavsen,2011,h,23,28,Vara,756,59,110776,35.7,Høyre,815,2011-09-12,96,4.37009822977008,6,160,154
kandidat001217,Kristoffer Gustavsen,2015,h,22,22,Vara,843,67,101882,31.8,Høyre,910,2015-09-14,242,4.60055437470119,8,402,394
kandidat001218,Kristoffer Robin Haug,2015,mdg,27,18,Ikke valgt,234,43,26096,8.14,Miljøpartiet De Grønne,277,2015-09-14,44,1.89998360631656,4,46,42
kandidat001219,Kristoffer Vold,2007,kp,48,46,Ikke valgt,0,0,120000,0.04,Kystpartiet,0,2007-09-10,2,0.292291131885157,1,2,1
kandidat001220,Kurtish Iljazi,2011,sp,23,18,Ikke valgt,15,0,1591,0.51,Senterpartiet,15,2011-09-12,2,0.0030184628406133,0,3,3
kandidat001221,Kurtish Iljazi,2015,sp,32,49,Ikke valgt,17,2,1926,0.6,Senterpartiet,19,2015-09-14,5,0.0565481881032463,0,8,8
kandidat001222,Kurt Mosbakk,2011,ap,58,38,Ikke valgt,397,3,102707,33.1,Det norske Arbeiderparti,400,2011-09-12,18,0.00898303356388542,0,814,814
kandidat001223,Kurt Ødegård,2007,dem,10,53,Ikke valgt,0,9,306000,0.11,Demokratene,9,2007-09-10,2,0.000130126958456866,0,2,2
kandidat001224,Kyrre Alvær,2015,v,25,20,Ikke valgt,163,25,21986,6.86,Venstre,188,2015-09-14,9,1.90254303713501,3,22,19
kandidat001225,Laila Al Hage El-Zein,2007,in,4,6,Ikke valgt,44,30,329000,0.12,Innvandrerpartiet,74,NA,0,0,0,0,0
kandidat001226,Laila Katnosa,2007,dem,7,4,Ikke valgt,9,3,306000,0.11,Demokratene,12,NA,0,0,0,0,0
kandidat001227,Laila Synnøve Jenssen Sundt,2011,pp,7,32,Ikke valgt,19,3,1045,0.34,Pensjonistpartiet,22,NA,0,0,0,0,0
kandidat001228,Laila Synnøve Jenssen Sundt,2015,pp,13,24,Ikke valgt,15,5,1169,0.36,Pensjonistpartiet,20,NA,0,0,0,0,0
kandidat001229,Lan Marie Nguyen Berg,2015,mdg,1,1,Valgt,3838,1136,26096,8.14,Miljøpartiet De Grønne,4974,2015-09-14,2537,176.696175937453,330,2562,2232
kandidat001230,Lars Asgeir Rottem Krangnes,2015,sp,14,15,Ikke valgt,33,13,1926,0.6,Senterpartiet,46,NA,0,0,0,0,0
kandidat001231,Lars Astrup,2007,dem,22,39,Ikke valgt,1,2,306000,0.11,Demokratene,3,2007-09-10,2,1.78359882850161e-10,0,10,10
kandidat001232,Lars Erik Bartnes,2011,sp,21,21,Ikke valgt,11,5,1591,0.51,Senterpartiet,16,2011-09-12,928,42.3433168379,53,951,898
kandidat001233,Lars-Erik Mangset,2011,mdg,56,43,Ikke valgt,25,1,7653,2.47,Miljøpartiet De Grønne,26,2011-09-12,2,0.616929823373552,1,2,1
kandidat001234,Lars Erik Stuberg,2007,sp,3,3,Ikke valgt,76,28,2189,0.81,Senterpartiet,104,2007-09-10,8,1.51962869299468,2,9,7
kandidat001235,Lars Erik Stuberg,2011,sp,26,48,Ikke valgt,11,4,1591,0.51,Senterpartiet,15,2011-09-12,21,0.00301846303432991,0,30,30
kandidat001236,Lars Gjemble,2011,sp,5,4,Ikke valgt,48,38,1591,0.51,Senterpartiet,86,2011-09-12,59,7.34157285584986,19,77,58
kandidat001237,Lars Gjemble,2015,sp,45,33,Ikke valgt,8,2,1926,0.6,Senterpartiet,10,2015-09-14,298,0.431725354455779,1,375,374
kandidat001238,Lars Gullbrand Helleberg,2007,rv,62,39,Ikke valgt,29,0,14131,5.2,Rød Valgallianse,29,NA,0,0,0,0,0
kandidat001239,Lars Ingar Toverud,2007,kp,31,42,Ikke valgt,1,1,120000,0.04,Kystpartiet,2,2007-09-10,73,0.0599090122811898,0,74,74
kandidat001240,Lars Johnsen,2007,rv,41,19,Ikke valgt,60,9,14131,5.2,Rød Valgallianse,69,2007-09-10,2064,50.4039694786536,127,2447,2320
kandidat001241,Lars Johnsen,2015,rv,60,40,Ikke valgt,63,5,16174,5.05,Rødt,68,2015-09-14,4806,86.7991594590924,183,10999,10816
kandidat001242,Lars K. Kullerud,2011,dem,19,14,Ikke valgt,3,0,214000,0.07,Demokratene i Norge,3,NA,0,0,0,0,0
kandidat001243,Lars Lillo-Stenberg,2011,mdg,9,63,Ikke valgt,171,38,7653,2.47,Miljøpartiet De Grønne,209,2011-09-12,3971,79.8493574662562,197,8024,7827
kandidat001244,Lars Lillo-Stenberg,2015,mdg,12,62,Vara,1332,85,26096,8.14,Miljøpartiet De Grønne,1417,2015-09-14,4098,104.323294168921,235,12122,11887
kandidat001245,Lars Madsen,2015,h,43,40,Ikke valgt,451,18,101882,31.8,Høyre,469,2015-09-14,88,1.94807337306624,3,172,169
kandidat001246,Lars Morten Johnsen,2011,rv,52,29,Ikke valgt,46,3,11257,3.63,Rødt,49,2011-09-12,2,0.000450568698216643,0,86,86
kandidat001247,Lars Nordlie,2007,mdg,35,15,Ikke valgt,12,0,1687,0.62,Miljøpartiet De Grønne,12,NA,0,0,0,0,0
kandidat001248,Lars Olav Fosse,2015,v,24,30,Ikke valgt,143,47,21986,6.86,Venstre,190,2015-09-14,39,1.56429986620756,3,119,116
kandidat001249,Lars Petter Solås,2007,frp,37,46,Ikke valgt,154,3,38873,14.3,Fremskrittspartiet,157,2007-09-10,2,1.91210514954509,2,2,0
kandidat001250,Lars Petter Solås,2015,frp,13,24,Ikke valgt,200,38,19311,6.03,Fremskrittspartiet,238,2015-09-14,43,4.7583928396116,9,50,41
kandidat001251,Lars Raaum,2007,osby,29,30,Ikke valgt,13,9,1466,0.54,Oslo Byaksjon,22,2007-09-10,9,0.656807880526392,1,13,12
kandidat001252,Lars Rottem Krangnes,2007,sp,1,1,Ikke valgt,242,242,2189,0.81,Senterpartiet,484,2007-09-10,270,127.53170533076,147,272,125
kandidat001253,Lars Rottem Krangnes,2011,sp,7,8,Ikke valgt,37,23,1591,0.51,Senterpartiet,60,2011-09-12,131,0.0162391285456312,0,403,403
kandidat001254,Lars Skaret,2015,nkp,9,8,Ikke valgt,15,2,240,0.07,Norges Kommunistiske Parti,17,2015-09-14,7,7.98537484276314e-05,0,23,23
kandidat001255,Lasse Fredrik Qvigstad,2007,sfp,5,5,Ikke valgt,6,12,129000,0.05,Samfunnspartiet,18,NA,0,0,0,0,0
kandidat001256,Lasse Heimdal,2015,krf,23,21,Ikke valgt,107,12,7827,2.44,Kristelig Folkeparti,119,2015-09-14,956,27.5172441145548,34,2101,2067
kandidat001257,Lasse Østervold,2007,mdg,7,5,Ikke valgt,66,29,1687,0.62,Miljøpartiet De Grønne,95,2007-09-10,2,3.19366224180582e-12,0,8,8
kandidat001258,Lasse Østervold,2011,mdg,50,37,Ikke valgt,23,7,7653,2.47,Miljøpartiet De Grønne,30,2011-09-12,7,0.0148947707216593,0,15,15
kandidat001259,Leif Ari Ingholm,2015,mdg,46,22,Ikke valgt,129,19,26096,8.14,Miljøpartiet De Grønne,148,NA,0,0,0,0,0
kandidat001260,Leif Christian Roberg,2015,v,56,48,Ikke valgt,82,6,21986,6.86,Venstre,88,NA,0,0,0,0,0
kandidat001261,Leif Endre Grutle,2007,krf,55,36,Ikke valgt,23,1,8368,3.08,Kristelig Folkeparti,24,2007-09-10,2,0.946118573843009,1,8,7
kandidat001262,Leif Harald Tesdal,2011,dem,24,21,Ikke valgt,2,0,214000,0.07,Demokratene i Norge,2,2011-09-12,3,0.035614588160815,0,10,10
kandidat001263,Leif Harald Tesdal,2015,dem,7,6,Ikke valgt,33,4,740,0.23,Demokratene i Norge,37,2015-09-14,7,0.0365070008169658,0,17,17
kandidat001264,Leif Kristensen,2007,frp,48,36,Ikke valgt,102,2,38873,14.3,Fremskrittspartiet,104,2007-09-10,30,0.709745140947211,2,82,80
kandidat001265,Lena Jensen,2015,sv,46,52,Ikke valgt,122,2,17445,5.44,Sosialistisk Venstreparti,124,2015-09-14,840,1.11356350143314,1,8468,8467
kandidat001266,Lena Sæterli,2015,ap,40,32,Vara,1078,28,102431,31.97,Arbeiderpartiet,1106,2015-09-14,14,0.0826860470071925,0,24,24
kandidat001267,Lene Dolly Langemyr,2007,frp,15,16,Vara,307,36,38873,14.3,Fremskrittspartiet,343,NA,0,0,0,0,0
kandidat001268,Lene Løken,2015,ap,51,56,Ikke valgt,714,31,102431,31.97,Arbeiderpartiet,745,2015-09-14,440,13.0382632391461,30,3113,3083
kandidat001269,Lene Nilsen,2015,fi,2,2,Ikke valgt,117,220,1388,0.43,Feministisk Initiativ,337,2015-09-14,219,7.46613901170065,19,617,598
kandidat001270,Lene Sundfær Haug,2015,h,50,44,Ikke valgt,366,14,101882,31.8,Høyre,380,2015-09-14,2,0.694298830649021,2,2,0
kandidat001271,Lene Therese Linnemørken,2015,frp,27,29,Ikke valgt,135,7,19311,6.03,Fremskrittspartiet,142,NA,0,0,0,0,0
kandidat001272,Leon Bodd,2007,v,8,11,Vara,609,130,23703,8.72,Venstre,739,2007-09-10,63,3.12510910760425,5,874,869
kandidat001273,Leyla Algünerhan,2007,rv,25,28,Ikke valgt,133,8,14131,5.2,Rød Valgallianse,141,2007-09-10,1,9.45720036642129e-15,0,3,3
kandidat001274,Libe Rieber-Mohn,2011,ap,1,1,Valgt,14119,849,102707,33.1,Det norske Arbeiderparti,14968,2011-09-12,6467,957.470672821949,1465,8697,7232
kandidat001275,Lillan Nora Berglund,2015,ksp,13,18,Ikke valgt,11,0,421,0.13,Partiet De Kristne,11,2015-09-14,1,0,0,3,3
kandidat001276,Lillian Åsheim,2007,kp,49,49,Ikke valgt,0,0,120000,0.04,Kystpartiet,0,NA,0,0,0,0,0
kandidat001277,Lillian Bredal Eriksen,2015,mdg,25,17,Ikke valgt,274,50,26096,8.14,Miljøpartiet De Grønne,324,2015-09-14,17,4.18661534685762,6,19,13
kandidat001278,Lillian Hatling,2007,sp,12,10,Ikke valgt,33,3,2189,0.81,Senterpartiet,36,2007-09-10,13,0.0148086409314412,0,18,18
kandidat001279,Lillian Oulie,2015,dem,8,7,Ikke valgt,23,1,740,0.23,Demokratene i Norge,24,2015-09-14,2,0.00167166320418743,0,4,4
kandidat001280,Lillian Woxen,2007,kp,18,47,Ikke valgt,1,2,120000,0.04,Kystpartiet,3,NA,0,0,0,0,0
kandidat001281,Lillian Woxen,2015,kp,15,17,Ikke valgt,5,0,124,0.04,Kystpartiet,5,NA,0,0,0,0,0
kandidat001282,Lill Pleym,2011,sv,33,31,Ikke valgt,161,9,19477,6.28,Sosialistisk Venstreparti,170,2011-09-12,86,2.23583789673425,9,118,109
kandidat001283,Lilly Kristin Langnes,2011,krf,22,12,Ikke valgt,109,7,7571,2.44,Kristelig Folkeparti,116,2011-09-12,6,0.012144533112375,0,7,7
kandidat001284,Lilly Kristin Langnes,2015,krf,18,13,Ikke valgt,121,13,7827,2.44,Kristelig Folkeparti,134,2015-09-14,6,0.0171993680771473,0,13,13
kandidat001285,Lina Marcela Alvarez Reyes,2015,fi,21,21,Ikke valgt,30,2,1388,0.43,Feministisk Initiativ,32,NA,0,0,0,0,0
kandidat001286,Linda Charlotte Ulriksen,2011,nkp,8,7,Ikke valgt,14,1,210000,0.07,Norges Kommunistiske Parti,15,NA,0,0,0,0,0
kandidat001287,Linda C. Ulriksen,2007,nkp,11,11,Ikke valgt,9,0,203000,0.07,Norges Kommunistiske Parti,9,NA,0,0,0,0,0
kandidat001288,Linda Emilie Ellingsen,2007,h,24,20,Vara,611,20,68475,25.19,Høyre,631,2007-09-10,14,0.00382575792316937,0,31,31
kandidat001289,Linda Hægdahl,2015,rv,59,56,Ikke valgt,70,2,16174,5.05,Rødt,72,2015-09-14,1,0,0,2,2
kandidat001290,Linda Øvrum,2007,dem,13,8,Ikke valgt,4,1,306000,0.11,Demokratene,5,NA,0,0,0,0,0
kandidat001291,Linda Renee H. Stormo,2007,mdg,47,36,Ikke valgt,7,0,1687,0.62,Miljøpartiet De Grønne,7,NA,0,0,0,0,0
kandidat001292,Linda Tinuke Strandmyr,2015,rv,45,52,Ikke valgt,104,10,16174,5.05,Rødt,114,2015-09-14,3,3.1982524255858e-06,0,6,6
kandidat001293,Line Schou,2015,fi,11,10,Ikke valgt,37,19,1388,0.43,Feministisk Initiativ,56,2015-09-14,68,6.47766134615081,11,333,322
kandidat001294,Line Tresselt,2015,ap,60,58,Ikke valgt,564,19,102431,31.97,Arbeiderpartiet,583,2015-09-14,183,2.30180765365193,4,209,205
kandidat001295,Line Weber Skjærpe,2011,h,57,50,Ikke valgt,270,13,110776,35.7,Høyre,283,2011-09-12,3,0.0110204852632081,0,15,15
kandidat001296,Lisa Benedikte Albrigtsen,2015,ksp,12,15,Ikke valgt,11,0,421,0.13,Partiet De Kristne,11,2015-09-14,2,1.84543182962329,2,2,0
kandidat001297,Lisbet Natland,2015,frp,32,20,Ikke valgt,103,10,19311,6.03,Fremskrittspartiet,113,2015-09-14,6,0.00156511127456114,0,76,76
kandidat001298,Liselotte Lunde,2011,v,38,49,Ikke valgt,113,16,25351,8.17,Venstre,129,2011-09-12,156,2.03135905463111,2,212,210
kandidat001299,Lise Spikkeland,2007,sv,43,39,Ikke valgt,141,2,28701,10.56,Sosialistisk Venstreparti,143,2007-09-10,3,5.47253067833881e-08,0,5,5
kandidat001300,Lise Spikkeland,2011,sv,40,25,Ikke valgt,129,10,19477,6.28,Sosialistisk Venstreparti,139,2011-09-12,9,1.31918465206616e-05,0,14,14
kandidat001301,Live Gundersen,2015,rv,25,19,Ikke valgt,170,9,16174,5.05,Rødt,179,2015-09-14,11,0.813199252028527,1,20,19
kandidat001302,Liv Gulbrandsen,2011,rv,15,15,Ikke valgt,295,61,11257,3.63,Rødt,356,2011-09-12,128,1.26812950168389,3,562,559
kandidat001303,Liv Heidrun Rising,2007,nkp,10,6,Ikke valgt,9,0,203000,0.07,Norges Kommunistiske Parti,9,NA,0,0,0,0,0
kandidat001304,Liv Herdiis Wiborg,2011,v,60,63,Ikke valgt,52,4,25351,8.17,Venstre,56,2011-09-12,1,7.13923914909935e-13,0,3,3
kandidat001305,Liv Hilde Dimmestøl,2007,mdg,33,44,Ikke valgt,14,0,1687,0.62,Miljøpartiet De Grønne,14,NA,0,0,0,0,0
kandidat001306,Liv Hilt Jørgensen,2007,nkp,13,16,Ikke valgt,6,3,203000,0.07,Norges Kommunistiske Parti,9,NA,0,0,0,0,0
kandidat001307,Liv Irene Haug,2007,v,53,37,Ikke valgt,110,9,23703,8.72,Venstre,119,2007-09-10,24,5.71744192312923,12,61,49
kandidat001308,Liv Irene Haug,2011,v,39,35,Ikke valgt,118,3,25351,8.17,Venstre,121,2011-09-12,361,0.0247989249033519,0,422,422
kandidat001309,Liv Jorunn Eriksen,2011,sv,44,37,Ikke valgt,105,11,19477,6.28,Sosialistisk Venstreparti,116,2011-09-12,186,3.1618500976773,5,250,245
kandidat001310,Liv Lønnum,2011,frp,14,16,Ikke valgt,208,23,21852,7.04,Fremskrittspartiet,231,2011-09-12,20,1.57268472013904,2,25,23
kandidat001311,Liv Torill Evenrud,2015,sp,13,11,Ikke valgt,42,4,1926,0.6,Senterpartiet,46,2015-09-14,76,1.24388305793979,3,806,803
kandidat001312,Liv Undem,2007,sv,21,12,Ikke valgt,382,31,28701,10.56,Sosialistisk Venstreparti,413,2007-09-10,26,1.65436410832524,4,31,27
kandidat001313,Lone Alice Johansen,2015,fi,3,3,Ikke valgt,84,108,1388,0.43,Feministisk Initiativ,192,2015-09-14,67,3.12715655312499,3,70,67
kandidat001314,Lourdes Saint-Pasteur,2007,sv,36,35,Ikke valgt,169,12,28701,10.56,Sosialistisk Venstreparti,181,2007-09-10,2,6.63525169393355e-08,0,2,2
kandidat001315,Lourdes Saint-Pasteur,2011,sv,34,15,Ikke valgt,148,13,19477,6.28,Sosialistisk Venstreparti,161,2011-09-12,7,0.452756134216672,4,9,5
kandidat001316,Luca Dalen Espseth,2015,sv,11,14,Ikke valgt,436,118,17445,5.44,Sosialistisk Venstreparti,554,2015-09-14,115,6.1877156609931,14,115,101
kandidat001317,Lula Woldu,2011,sp,34,53,Ikke valgt,9,3,1591,0.51,Senterpartiet,12,2011-09-12,4,1.16985864393576,2,4,2
kandidat001318,Lula Woldu,2015,sp,48,41,Ikke valgt,7,1,1926,0.6,Senterpartiet,8,2015-09-14,1,2.96369269507562e-11,0,5,5
kandidat001319,Mads Bjørkli,2011,dem,22,9,Ikke valgt,1,1,214000,0.07,Demokratene i Norge,2,2011-09-12,15,0.813104727649707,1,24,23
kandidat001320,Magnar Tanem,2011,ksp,1,1,Ikke valgt,27,20,235000,0.08,Kristent Samlingsparti,47,2011-09-12,24,11.3574747593911,23,24,1
kandidat001321,Magne Gjelseth,2007,frp,25,18,Ikke valgt,208,10,38873,14.3,Fremskrittspartiet,218,2007-09-10,19,1.18183784570692,3,42,39
kandidat001322,Magne Gjerde,2011,sp,44,32,Ikke valgt,9,0,1591,0.51,Senterpartiet,9,2011-09-12,231,11.2410339610427,30,392,362
kandidat001323,Magne M. Wiggen,2007,osby,17,27,Ikke valgt,25,8,1466,0.54,Oslo Byaksjon,33,2007-09-10,14,0.977778679861616,1,22,21
kandidat001324,Magne Storebø,2015,krf,44,52,Ikke valgt,21,17,7827,2.44,Kristelig Folkeparti,38,2015-09-14,17,1.97694359613968,4,33,29
kandidat001325,Magnhild Skurdal,2007,mdg,10,9,Ikke valgt,43,7,1687,0.62,Miljøpartiet De Grønne,50,NA,0,0,0,0,0
kandidat001326,Magnus Holtfodt,2015,fi,17,14,Ikke valgt,32,8,1388,0.43,Feministisk Initiativ,40,NA,0,0,0,0,0
kandidat001327,Magnus Ledang Husøy,2015,krf,56,36,Ikke valgt,19,1,7827,2.44,Kristelig Folkeparti,20,NA,0,0,0,0,0
kandidat001328,Maika Godal Dam,2015,ap,53,54,Ikke valgt,627,69,102431,31.97,Arbeiderpartiet,696,2015-09-14,14,0.00638585824089681,0,17,17
kandidat001329,Målfrid Braut-Hegghammer,2007,v,36,28,Ikke valgt,175,9,23703,8.72,Venstre,184,2007-09-10,4,0.0141930930478546,0,4,4
kandidat001330,Malin Jacob,2015,sv,16,11,Ikke valgt,404,61,17445,5.44,Sosialistisk Venstreparti,465,2015-09-14,179,7.93429804274431,16,444,428
kandidat001331,Malin Lenita Vik,2015,rv,28,35,Ikke valgt,148,23,16174,5.05,Rødt,171,2015-09-14,257,1.17466038841033,3,267,264
kandidat001332,Manjit Kaur,2007,mdg,31,46,Ikke valgt,14,3,1687,0.62,Miljøpartiet De Grønne,17,2007-09-10,10,0.0735281608840172,0,17,17
kandidat001333,Manuel Pettersen Lains,2015,pirat,8,4,Ikke valgt,31,7,805,0.25,Piratpartiet,38,2015-09-14,1,7.74669140669954e-09,0,1,1
kandidat001334,Marcus Thomassen,2007,mdg,36,19,Ikke valgt,10,2,1687,0.62,Miljøpartiet De Grønne,12,2007-09-10,2,7.44094688696612e-10,0,2,2
kandidat001335,Maren Hersleth Holsen,2007,v,51,40,Ikke valgt,122,1,23703,8.72,Venstre,123,2007-09-10,68,0.0554822995822985,0,115,115
kandidat001336,Maren Malthe-Sørenssen,2011,h,21,40,Valgt,817,28,110776,35.7,Høyre,845,2011-09-12,23,0.46427178596187,1,23,22
kandidat001337,Maren Malthe-Sørenssen,2015,h,19,24,Valgt,1069,48,101882,31.8,Høyre,1117,2015-09-14,118,13.6918530487518,20,141,121
kandidat001338,Maren Rismyhr,2007,rv,15,11,Ikke valgt,244,26,14131,5.2,Rød Valgallianse,270,2007-09-10,68,1.89910443469261,3,78,75
kandidat001339,Maren Rismyhr,2011,rv,30,21,Ikke valgt,99,10,11257,3.63,Rødt,109,2011-09-12,111,6.33102356413642,10,189,179
kandidat001340,Maren Rismyhr,2015,rv,19,14,Ikke valgt,290,47,16174,5.05,Rødt,337,2015-09-14,85,4.95897633304257,8,274,266
kandidat001341,Maret Petersson,2015,mdg,58,45,Ikke valgt,101,4,26096,8.14,Miljøpartiet De Grønne,105,NA,0,0,0,0,0
kandidat001342,Margaret Eckbo,2015,frp,18,25,Ikke valgt,192,11,19311,6.03,Fremskrittspartiet,203,2015-09-14,94,0.0103370739245944,0,2301,2301
kandidat001343,Margaret Eide Hillestad,2007,sp,6,4,Ikke valgt,68,25,2189,0.81,Senterpartiet,93,2007-09-10,74,4.38547070756559,9,184,175
kandidat001344,Margaret Eide Hillestad,2011,sp,2,1,Ikke valgt,131,60,1591,0.51,Senterpartiet,191,2011-09-12,677,52.6049483391176,83,861,778
kandidat001345,Margaret Eide Hillestad,2015,sp,20,52,Ikke valgt,25,6,1926,0.6,Senterpartiet,31,2015-09-14,70,3.11956810386003,4,931,927
kandidat001346,Margrethe Blomsø,2011,sp,15,16,Ikke valgt,21,2,1591,0.51,Senterpartiet,23,2011-09-12,34,4.55519702558601,16,90,74
kandidat001347,Margrethe Valler,2011,mdg,12,10,Ikke valgt,107,13,7653,2.47,Miljøpartiet De Grønne,120,2011-09-12,12,0.000956289249520129,0,13,13
kandidat001348,Maria Angel Dupont,2011,h,17,22,Valgt,950,13,110776,35.7,Høyre,963,2011-09-12,1,0.891366143906831,1,1,0
kandidat001349,Maria Caroline Klose,2015,v,52,41,Ikke valgt,94,2,21986,6.86,Venstre,96,2015-09-14,1,8.49319994582112e-09,0,1,1
kandidat001350,Maria Cecelia A. Ingles,2007,rv,33,20,Ikke valgt,85,4,14131,5.2,Rød Valgallianse,89,NA,0,0,0,0,0
kandidat001351,Maria Göthner,2015,h,25,25,Vara,735,45,101882,31.8,Høyre,780,2015-09-14,26,0.749452532877049,2,37,35
kandidat001352,Maria Kalstø,2015,mdg,41,43,Ikke valgt,166,5,26096,8.14,Miljøpartiet De Grønne,171,2015-09-14,2,0.00745404457127362,0,7,7
kandidat001353,Maria K. Göthner,2011,h,30,29,Vara,658,25,110776,35.7,Høyre,683,2011-09-12,3,0.0254765781891014,0,3,3
kandidat001354,Marian Abdi Hussein,2015,sv,15,15,Ikke valgt,433,49,17445,5.44,Sosialistisk Venstreparti,482,2015-09-14,2,1.37240439448782e-10,0,2,2
kandidat001355,Mariann Bakken,2007,mdg,41,34,Ikke valgt,8,0,1687,0.62,Miljøpartiet De Grønne,8,2007-09-10,8,0.912424635753054,1,13,12
kandidat001356,Marianne Andenæs,2015,ap,52,60,Ikke valgt,671,62,102431,31.97,Arbeiderpartiet,733,2015-09-14,193,5.15421401784026,23,193,170
kandidat001357,Marianne Bjørndal,2007,osby,49,49,Ikke valgt,7,3,1466,0.54,Oslo Byaksjon,10,2007-09-10,19,0.0132221773222261,0,47,47
kandidat001358,Marianne Borgen,2007,sv,2,2,Valgt,2852,682,28701,10.56,Sosialistisk Venstreparti,3534,2007-09-10,1625,231.893513578172,318,2060,1742
kandidat001359,Marianne Borgen,2011,sv,1,1,Valgt,2170,698,19477,6.28,Sosialistisk Venstreparti,2868,2011-09-12,2072,227.612979358205,426,4132,3706
kandidat001360,Marianne Borgen,2015,sv,1,1,Valgt,2876,1195,17445,5.44,Sosialistisk Venstreparti,4071,2015-09-14,4563,216.294710556364,429,8695,8266
kandidat001361,Marianne Bruusgaard,2007,mdg,14,14,Ikke valgt,29,6,1687,0.62,Miljøpartiet De Grønne,35,2007-09-10,4,1.45560275855509e-10,0,22,22
kandidat001362,Marianne Hagenhoff,2007,mdg,32,24,Ikke valgt,13,1,1687,0.62,Miljøpartiet De Grønne,14,NA,0,0,0,0,0
kandidat001363,Marianne Hagenhoff,2011,mdg,55,58,Ikke valgt,23,4,7653,2.47,Miljøpartiet De Grønne,27,2011-09-12,2,0.0522201576949067,0,2,2
kandidat001364,Marianne Lange Krogh,2011,rv,59,47,Ikke valgt,33,2,11257,3.63,Rødt,35,2011-09-12,1,4.81637281098157e-12,0,1,1
kandidat001365,Marianne Nordli,2007,frp,30,41,Ikke valgt,161,12,38873,14.3,Fremskrittspartiet,173,2007-09-10,136,0.681979108368947,2,194,192
kandidat001366,Marianne Nordli,2011,frp,10,10,Vara,286,19,21852,7.04,Fremskrittspartiet,305,2011-09-12,188,5.09530728114681,10,382,372
kandidat001367,Marianne Støylen,2015,v,38,54,Ikke valgt,117,13,21986,6.86,Venstre,130,2015-09-14,26,1.36313110828728,4,36,32
kandidat001368,Maria Sau Fong Ho,2015,krf,47,31,Ikke valgt,30,1,7827,2.44,Kristelig Folkeparti,31,NA,0,0,0,0,0
kandidat001369,Maria Wattne,2015,fi,25,24,Ikke valgt,21,7,1388,0.43,Feministisk Initiativ,28,2015-09-14,34,0.0327503336784048,0,90,90
kandidat001370,Mari Berdal Djupvik,2011,h,41,21,Vara,470,35,110776,35.7,Høyre,505,2011-09-12,56,1.10587296719161,2,56,54
kandidat001371,Marielle Leraand,2011,rv,58,49,Ikke valgt,35,1,11257,3.63,Rødt,36,2011-09-12,117,2.96538608806885,6,345,339
kandidat001372,Marielle Leraand,2015,rv,31,28,Ikke valgt,159,7,16174,5.05,Rødt,166,2015-09-14,528,2.29905435127262,8,873,865
kandidat001373,Marie Loe Halvorsen,2015,mdg,8,7,Vara,910,85,26096,8.14,Miljøpartiet De Grønne,995,2015-09-14,82,1.64489177307062,3,105,102
kandidat001374,Marie Sneve Martinussen,2015,rv,32,42,Ikke valgt,151,12,16174,5.05,Rødt,163,2015-09-14,196,5.79529980100968,24,224,200
kandidat001375,Mariette Christophersen Bøe,2011,h,36,18,Vara,555,14,110776,35.7,Høyre,569,2011-09-12,2,1.82421029909018,2,2,0
kandidat001376,Mariette Lobo,2011,rv,48,39,Ikke valgt,51,7,11257,3.63,Rødt,58,2011-09-12,105,1.11993343403569,2,146,144
kandidat001377,Mariette Lobo,2015,rv,46,32,Ikke valgt,99,11,16174,5.05,Rødt,110,2015-09-14,38,0.103801572179029,0,184,184
kandidat001378,Marijke Berdahl,2007,rv,7,7,Vara,303,30,14131,5.2,Rød Valgallianse,333,2007-09-10,9,0.00965680007723833,0,63,63
kandidat001379,Marijke Berdahl,2011,rv,33,35,Ikke valgt,86,7,11257,3.63,Rødt,93,2011-09-12,3,0.0159587433655602,0,66,66
kandidat001380,Mari Lending,2007,osby,23,42,Ikke valgt,17,9,1466,0.54,Oslo Byaksjon,26,2007-09-10,119,1.11521412437183,2,393,391
kandidat001381,Mari Lund Arnem,2015,sv,12,13,Ikke valgt,497,52,17445,5.44,Sosialistisk Venstreparti,549,2015-09-14,194,1.30633822164555e-05,0,256,256
kandidat001382,Mari Morken,2015,ap,26,18,Vara,1649,55,102431,31.97,Arbeiderpartiet,1704,2015-09-14,73,5.07457868250786,11,112,101
kandidat001383,Mari O. Mamre,2011,h,55,41,Ikke valgt,274,14,110776,35.7,Høyre,288,2011-09-12,93,3.45383318219294,6,94,88
kandidat001384,Mario Neira,2007,in,5,10,Ikke valgt,48,25,329000,0.12,Innvandrerpartiet,73,2007-09-10,2,0.000813627779120714,0,8,8
kandidat001385,Marion Godager Tveter,2015,mdg,7,5,Vara,972,166,26096,8.14,Miljøpartiet De Grønne,1138,2015-09-14,27,4.46897388932281,6,30,24
kandidat001386,Mari Røsjø,2007,rv,40,40,Ikke valgt,65,5,14131,5.2,Rød Valgallianse,70,2007-09-10,8,0.000155730113322194,0,12,12
kandidat001387,Mari Røsjø,2015,rv,36,47,Ikke valgt,146,5,16174,5.05,Rødt,151,2015-09-14,55,0.0040184760219182,0,83,83
kandidat001388,Marita Helen Pettersen,2011,sp,55,47,Ikke valgt,4,1,1591,0.51,Senterpartiet,5,2011-09-12,1,0.0020559854669876,0,4,4
kandidat001389,Marit Andrine Kraglund,2007,krf,21,14,Ikke valgt,67,9,8368,3.08,Kristelig Folkeparti,76,2007-09-10,65,10.6522161403606,58,66,8
kandidat001390,Marit Danielsen,2011,rv,43,28,Ikke valgt,61,3,11257,3.63,Rødt,64,2011-09-12,126,0.977920712004512,2,184,182
kandidat001391,Marit F. Danielsen,2007,rv,52,50,Ikke valgt,39,0,14131,5.2,Rød Valgallianse,39,NA,0,0,0,0,0
kandidat001392,Marit Gran,2007,pp,13,28,Ikke valgt,13,1,1414,0.52,Pensjonistpartiet,14,2007-09-10,210,2.47779217518142,4,263,259
kandidat001393,Marit Halse,2007,rv,21,13,Ikke valgt,170,2,14131,5.2,Rød Valgallianse,172,2007-09-10,8,1.29481592338026,2,24,22
kandidat001394,Marit Halse,2011,rv,4,10,Vara,334,62,11257,3.63,Rødt,396,2011-09-12,30,3.95874728754079,7,54,47
kandidat001395,Marit Halse,2015,rv,4,5,Vara,788,138,16174,5.05,Rødt,926,2015-09-14,117,2.02353523622794,5,171,166
kandidat001396,Marit Hansen,2007,ap,44,46,Ikke valgt,466,13,81265,29.89,Det norske Arbeiderparti,479,2007-09-10,188,8.51085367259981,17,406,389
kandidat001397,Marit Johanne Bjerke,2011,ap,46,59,Ikke valgt,530,27,102707,33.1,Det norske Arbeiderparti,557,2011-09-12,22,1.01182736385872,1,25,24
kandidat001398,Marit Kamøy,2015,v,22,15,Ikke valgt,196,5,21986,6.86,Venstre,201,2015-09-14,18,2.25479339581986,3,22,19
kandidat001399,Marit Karlsen,2007,osby,44,56,Ikke valgt,9,2,1466,0.54,Oslo Byaksjon,11,2007-09-10,206,0.880375327134258,3,450,447
kandidat001400,Marit Kristine Vea,2015,v,29,59,Ikke valgt,154,18,21986,6.86,Venstre,172,2015-09-14,80,0.540901360024087,1,86,85
kandidat001401,Marit Momrak Wright,2007,krf,37,61,Ikke valgt,30,3,8368,3.08,Kristelig Folkeparti,33,2007-09-10,3,0.398824269387074,1,19,18
kandidat001402,Marit Momrak Wright,2011,krf,23,18,Ikke valgt,100,15,7571,2.44,Kristelig Folkeparti,115,2011-09-12,157,1.82682520480834,3,176,173
kandidat001403,Marius Berge Eide,2015,sv,53,34,Ikke valgt,65,2,17445,5.44,Sosialistisk Venstreparti,67,2015-09-14,12,1.74311928744948e-05,0,50,50
kandidat001404,Marius Joakim Gundersen,2007,kp,15,19,Ikke valgt,0,3,120000,0.04,Kystpartiet,3,NA,0,0,0,0,0
kandidat001405,Marius Pellerud,2007,sv,27,15,Ikke valgt,261,30,28701,10.56,Sosialistisk Venstreparti,291,2007-09-10,1,0.813019649987571,1,1,0
kandidat001406,Marius Pellerud,2011,sv,37,24,Ikke valgt,137,13,19477,6.28,Sosialistisk Venstreparti,150,2011-09-12,5,0.457527348112096,1,6,5
kandidat001407,Mark Kagabo Kibibiro,2007,rv,28,32,Ikke valgt,107,8,14131,5.2,Rød Valgallianse,115,NA,0,0,0,0,0
kandidat001408,Mark Rødseth,2011,kp,19,17,Ikke valgt,2,0,126000,0.04,Kystpartiet,2,NA,0,0,0,0,0
kandidat001409,Markus Hansen,2015,rv,49,29,Ikke valgt,102,5,16174,5.05,Rødt,107,2015-09-14,508,16.2375218117448,34,639,605
kandidat001410,Marta Elena Valdés,2007,sv,25,22,Ikke valgt,299,9,28701,10.56,Sosialistisk Venstreparti,308,2007-09-10,2,6.59468026433617e-12,0,3,3
kandidat001411,Marte Kristine Smedsrød,2007,mdg,30,32,Ikke valgt,16,1,1687,0.62,Miljøpartiet De Grønne,17,NA,0,0,0,0,0
kandidat001412,Marte Stine Skinnerlien,2015,fi,14,9,Ikke valgt,30,13,1388,0.43,Feministisk Initiativ,43,2015-09-14,3,8.51232239025069e-06,0,3,3
kandidat001413,Martha Hagerup Nilson,2007,v,11,7,Vara,471,31,23703,8.72,Venstre,502,2007-09-10,2,0.00362360208817849,0,2,2
kandidat001414,Martin Bekkelund,2011,v,19,23,Ikke valgt,225,22,25351,8.17,Venstre,247,2011-09-12,90,3.06471160666016,5,100,95
kandidat001415,Martin Borander,2011,nkp,14,10,Ikke valgt,7,2,210000,0.07,Norges Kommunistiske Parti,9,2011-09-12,4,0.282239308699299,1,4,3
kandidat001416,Martin Bould,2007,osby,64,60,Ikke valgt,1,0,1466,0.54,Oslo Byaksjon,1,2007-09-10,5,1.96162113942996e-08,0,9,9
kandidat001417,Martin Fagereng Johansen,2011,dlf,5,7,Ikke valgt,10,2,247000,0.08,Det Liberale Folkepartiet,12,NA,0,0,0,0,0
kandidat001418,Martin Grüner Larsen,2011,sv,30,46,Ikke valgt,156,48,19477,6.28,Sosialistisk Venstreparti,204,2011-09-12,186,6.16606879676325,13,203,190
kandidat001419,Martin Gunnar Nag,2011,nkp,4,13,Ikke valgt,14,8,210000,0.07,Norges Kommunistiske Parti,22,2011-09-12,1,5.98403835927523e-07,0,1,1
kandidat001420,Martin Gunnar Nag,2015,nkp,10,11,Ikke valgt,14,3,240,0.07,Norges Kommunistiske Parti,17,2015-09-14,2,0.13792854953545,0,3,3
kandidat001421,Martin Johansen,2007,dlf,9,4,Ikke valgt,3,1,127000,0.05,Det Liberale Folkepartiet,4,2007-09-10,554,24.190161131808,55,2206,2151
kandidat001422,Martin Nag,2007,nkp,3,9,Ikke valgt,8,17,203000,0.07,Norges Kommunistiske Parti,25,2007-09-10,59,3.67452232597439,8,774,766
kandidat001423,Martin Sverdvik,2007,mdg,13,23,Ikke valgt,16,21,1687,0.62,Miljøpartiet De Grønne,37,NA,0,0,0,0,0
kandidat001424,Mathea Fjukstad Hansen,2015,krf,24,25,Ikke valgt,107,6,7827,2.44,Kristelig Folkeparti,113,2015-09-14,5,1.64582663739038,2,6,4
kandidat001425,Mathias Frednes,2015,nkp,5,5,Ikke valgt,25,2,240,0.07,Norges Kommunistiske Parti,27,2015-09-14,1,5.58506265532297e-07,0,2,2
kandidat001426,Mathilde Tybring-Gjedde,2015,h,11,13,Valgt,1893,101,101882,31.8,Høyre,1994,2015-09-14,222,6.96612481317642,15,254,239
kandidat001427,Mats Kirkebirkeland,2015,h,60,55,Ikke valgt,264,38,101882,31.8,Høyre,302,2015-09-14,144,14.2240023390816,42,149,107
kandidat001428,Matthew Smith,2007,mdg,2,3,Ikke valgt,108,73,1687,0.62,Miljøpartiet De Grønne,181,2007-09-10,13,0.617733493100146,4,24,20
kandidat001429,Matti Lucie Arentz,2011,v,28,22,Ikke valgt,145,29,25351,8.17,Venstre,174,2011-09-12,36,1.74678298744845,3,47,44
kandidat001430,Mattis Ulvang,2015,mdg,51,34,Ikke valgt,129,8,26096,8.14,Miljøpartiet De Grønne,137,2015-09-14,4,0,0,7,7
kandidat001431,Mauricio Deliz,2007,mdg,46,57,Ikke valgt,8,0,1687,0.62,Miljøpartiet De Grønne,8,2007-09-10,3,0.0604466392657523,0,4,4
kandidat001432,May-Brith Døssland,2011,v,34,31,Ikke valgt,126,10,25351,8.17,Venstre,136,2011-09-12,92,4.61730324142768,12,97,85
kandidat001433,May-Britt Christensen,2007,ap,22,16,Vara,982,16,81265,29.89,Det norske Arbeiderparti,998,2007-09-10,21,1.14099015096691,3,27,24
kandidat001434,May Grimdalen,2011,krf,6,4,Ikke valgt,226,26,7571,2.44,Kristelig Folkeparti,252,2011-09-12,25,2.80350876146839,4,220,216
kandidat001435,May-Lisbeth Myrhaug,2007,ap,49,34,Ikke valgt,403,17,81265,29.89,Det norske Arbeiderparti,420,2007-09-10,38,2.17901303056282,3,48,45
kandidat001436,Mayo Bustos,2007,nkp,2,3,Ikke valgt,16,15,203000,0.07,Norges Kommunistiske Parti,31,NA,0,0,0,0,0
kandidat001437,Mayo Bustos Alfaro,2011,nkp,6,5,Ikke valgt,13,6,210000,0.07,Norges Kommunistiske Parti,19,NA,0,0,0,0,0
kandidat001438,Mayo Bustos Alfaro,2015,nkp,2,2,Ikke valgt,27,12,240,0.07,Norges Kommunistiske Parti,39,NA,0,0,0,0,0
kandidat001439,May Østhassel,2015,ksp,18,16,Ikke valgt,4,4,421,0.13,Partiet De Kristne,8,2015-09-14,1,1.27497359038232e-05,0,2,2
kandidat001440,Mazyar Keshvari,2007,frp,11,11,Vara,416,35,38873,14.3,Fremskrittspartiet,451,2007-09-10,73,15.8436180317784,36,77,41
kandidat001441,Mazyar Keshvari,2011,frp,4,6,Valgt,513,76,21852,7.04,Fremskrittspartiet,589,2011-09-12,1049,26.2584690183633,54,1126,1072
kandidat001442,Mehmet Naci Akkøk,2015,v,19,19,Ikke valgt,208,56,21986,6.86,Venstre,264,NA,0,0,0,0,0
kandidat001443,Meral Erdogan,2007,rv,43,35,Ikke valgt,53,6,14131,5.2,Rød Valgallianse,59,2007-09-10,1,0.91210514954509,1,1,0
kandidat001444,Merethe Reklev,2007,dlf,8,12,Ikke valgt,4,1,127000,0.05,Det Liberale Folkepartiet,5,2007-09-10,3,3.33267040279922e-11,0,4,4
kandidat001445,Mertefe Bartinlioglu,2007,h,17,16,Vara,873,64,68475,25.19,Høyre,937,2007-09-10,20,0.914419972968572,1,22,21
kandidat001446,Mertefe Bartinlioglu,2011,h,26,14,Vara,688,52,110776,35.7,Høyre,740,2011-09-12,76,2.9871957009203,5,98,93
kandidat001447,Mette Bjerkelien,2007,dem,25,21,Ikke valgt,1,1,306000,0.11,Demokratene,2,NA,0,0,0,0,0
kandidat001448,Michal Bergseth,2015,pirat,19,12,Ikke valgt,18,3,805,0.25,Piratpartiet,21,2015-09-14,3,0.0219717003809169,0,8,8
kandidat001449,Mikkelai Downing,2011,mdg,51,49,Ikke valgt,28,2,7653,2.47,Miljøpartiet De Grønne,30,2011-09-12,1,0.0115392616702114,0,5,5
kandidat001450,Mikkel Dahl Strømstad,2007,h,48,56,Ikke valgt,234,10,68475,25.19,Høyre,244,2007-09-10,1,0.525187467067436,1,2,1
kandidat001451,Mikkel Storm Glomstein,2011,mdg,17,33,Ikke valgt,63,24,7653,2.47,Miljøpartiet De Grønne,87,2011-09-12,10,0.00100123832880715,0,19,19
kandidat001452,Milla Sandborg Mathisen,2015,ap,58,46,Ikke valgt,583,26,102431,31.97,Arbeiderpartiet,609,2015-09-14,13,2.87718909456872,6,14,8
kandidat001453,Miloslav Brandl Hellenes,2015,ksp,17,11,Ikke valgt,6,2,421,0.13,Partiet De Kristne,8,NA,0,0,0,0,0
kandidat001454,Milos Rados,2015,ap,48,31,Ikke valgt,734,84,102431,31.97,Arbeiderpartiet,818,2015-09-14,67,1.52889043594349,5,141,136
kandidat001455,Mimir Kristjansson,2007,rv,30,36,Ikke valgt,92,6,14131,5.2,Rød Valgallianse,98,2007-09-10,457,22.7438301327578,25,507,482
kandidat001456,Miriam Nygren,2007,pp,29,26,Ikke valgt,7,0,1414,0.52,Pensjonistpartiet,7,NA,0,0,0,0,0
kandidat001457,Miriam Nygren,2011,pp,25,13,Ikke valgt,9,0,1045,0.34,Pensjonistpartiet,9,2011-09-12,1,1.19923127092213e-08,0,7,7
kandidat001458,Miriam Nygren,2015,pp,17,12,Ikke valgt,10,2,1169,0.36,Pensjonistpartiet,12,NA,0,0,0,0,0
kandidat001459,Mobashar Banaras,2015,ap,13,23,Valgt,3938,76,102431,31.97,Arbeiderpartiet,4014,2015-09-14,74,7.34274931103301,10,150,140
kandidat001460,Mohamad Al-Samarai,2011,sv,38,54,Ikke valgt,136,10,19477,6.28,Sosialistisk Venstreparti,146,NA,0,0,0,0,0
kandidat001461,Mohamed Abdule,2007,in,7,7,Ikke valgt,46,21,329000,0.12,Innvandrerpartiet,67,NA,0,0,0,0,0
kandidat001462,Mohamed Ali,2015,fi,6,15,Ikke valgt,99,34,1388,0.43,Feministisk Initiativ,133,2015-09-14,1162,23.9222646506378,65,2187,2122
kandidat001463,Mohammad Ghannam,2015,rv,47,33,Ikke valgt,102,7,16174,5.05,Rødt,109,2015-09-14,1,0,0,1,1
kandidat001464,Mohammad Iqbal Raja,2011,sv,9,14,Vara,595,214,19477,6.28,Sosialistisk Venstreparti,809,2011-09-12,2,1.51260214880685e-10,0,3,3
kandidat001465,Mohammad Nawaz Khan,2011,v,26,42,Ikke valgt,173,27,25351,8.17,Venstre,200,2011-09-12,1,0.977262483773277,1,1,0
kandidat001466,Mohammad Nawaz Khan,2015,v,34,39,Ikke valgt,136,14,21986,6.86,Venstre,150,NA,0,0,0,0,0
kandidat001467,Mohammad Shoaib Sultan,2015,mdg,2,4,Valgt,1226,468,26096,8.14,Miljøpartiet De Grønne,1694,2015-09-14,30,0.96922217969444,2,42,40
kandidat001468,Mohammed Al-Samarai,2007,sv,17,28,Ikke valgt,543,34,28701,10.56,Sosialistisk Venstreparti,577,2007-09-10,18,0.00130400662668653,0,20,20
kandidat001469,Mohammed Iqbal Raja,2007,sv,11,40,Vara,1332,97,28701,10.56,Sosialistisk Venstreparti,1429,2007-09-10,1,0.91210514954509,1,3,2
kandidat001470,Mohan Singh Varma,2007,in,2,1,Ikke valgt,54,84,329000,0.12,Innvandrerpartiet,138,2007-09-10,107,0.258100790894581,0,185,185
kandidat001471,Mona Enstad,2015,krf,36,22,Ikke valgt,48,8,7827,2.44,Kristelig Folkeparti,56,2015-09-14,195,13.1378009748249,22,1011,989
kandidat001472,Mona Helene Grønlie,2011,v,17,34,Ikke valgt,228,29,25351,8.17,Venstre,257,2011-09-12,14,0.768607139788043,2,21,19
kandidat001473,Mona Høvset,2007,krf,12,6,Ikke valgt,113,9,8368,3.08,Kristelig Folkeparti,122,2007-09-10,19,8.91909483783517,9,19,10
kandidat001474,Mona Høvset,2011,krf,35,20,Ikke valgt,54,13,7571,2.44,Kristelig Folkeparti,67,2011-09-12,150,13.3354233263032,19,169,150
kandidat001475,Mona Høvset,2015,krf,11,5,Ikke valgt,145,36,7827,2.44,Kristelig Folkeparti,181,2015-09-14,599,28.0463396444651,42,768,726
kandidat001476,Mona Klubben,2007,mdg,23,26,Ikke valgt,18,7,1687,0.62,Miljøpartiet De Grønne,25,2007-09-10,21,0.00107284311037174,0,23,23
kandidat001477,Mona Martinsen,2007,rv,58,46,Ikke valgt,34,0,14131,5.2,Rød Valgallianse,34,2007-09-10,28,1.29274555486759,4,43,39
kandidat001478,Mona Wærnes,2011,sv,32,39,Ikke valgt,169,8,19477,6.28,Sosialistisk Venstreparti,177,2011-09-12,46,0.00833614212542531,0,55,55
kandidat001479,Monica Aasen,2015,fi,26,25,Ikke valgt,20,8,1388,0.43,Feministisk Initiativ,28,2015-09-14,102,0.0771471592596133,0,137,137
kandidat001480,Monica Dyrø,2007,kp,10,14,Ikke valgt,3,2,120000,0.04,Kystpartiet,5,2007-09-10,4,0.00191891316812638,0,17,17
kandidat001481,Monica Dyrø,2011,kp,5,6,Ikke valgt,7,1,126000,0.04,Kystpartiet,8,NA,0,0,0,0,0
kandidat001482,Monica Mattsson,2011,ap,55,41,Ikke valgt,404,4,102707,33.1,Det norske Arbeiderparti,408,2011-09-12,16,1.15770190765881,11,23,12
kandidat001483,Monica Nkechi Okpe,2011,rv,26,19,Ikke valgt,117,7,11257,3.63,Rødt,124,2011-09-12,18,4.19107431691419,17,21,4
kandidat001484,Monica Semb Sætre,2015,ap,47,62,Ikke valgt,821,11,102431,31.97,Arbeiderpartiet,832,2015-09-14,7,0.0385308782996073,0,7,7
kandidat001485,Monica Tjelmeland,2007,v,13,10,Vara,417,40,23703,8.72,Venstre,457,2007-09-10,81,1.52446674846792,2,260,258
kandidat001486,Monika Frigård,2011,mdg,57,52,Ikke valgt,26,0,7653,2.47,Miljøpartiet De Grønne,26,2011-09-12,3,0.000341966244727854,0,3,3
kandidat001487,Monika Gulmoen,2007,rv,63,42,Ikke valgt,29,0,14131,5.2,Rød Valgallianse,29,2007-09-10,3,5.00080881921097e-05,0,4,4
kandidat001488,Morten Arne Sand,2007,dem,50,40,Ikke valgt,0,0,306000,0.11,Demokratene,0,NA,0,0,0,0,0
kandidat001489,Morten Bakke,2007,h,25,15,Vara,550,18,68475,25.19,Høyre,568,2007-09-10,532,23.1639376436808,45,4210,4165
kandidat001490,Morten Bakke,2011,h,29,13,Vara,657,40,110776,35.7,Høyre,697,2011-09-12,854,14.7239558074484,63,5064,5001
kandidat001491,Morten Bakke,2015,h,59,35,Ikke valgt,293,17,101882,31.8,Høyre,310,2015-09-14,563,20.2990386443357,45,5627,5582
kandidat001492,Morten Dahle Andersen,2011,krf,5,11,Vara,345,13,7571,2.44,Kristelig Folkeparti,358,2011-09-12,123,1.28552927532307,2,140,138
kandidat001493,Morten Daland,2007,dem,33,43,Ikke valgt,2,0,306000,0.11,Demokratene,2,2007-09-10,139,0.507154323036503,2,1008,1006
kandidat001494,Morten Dreyer,2007,osby,50,62,Ikke valgt,6,4,1466,0.54,Oslo Byaksjon,10,2007-09-10,81,2.24667492207183,6,167,161
kandidat001495,Morten Elster,2007,rv,9,10,Vara,207,47,14131,5.2,Rød Valgallianse,254,2007-09-10,25,1.20016928844887,2,25,23
kandidat001496,Morten Elster,2011,rv,9,6,Ikke valgt,212,66,11257,3.63,Rødt,278,2011-09-12,21,0.00875412123670039,0,46,46
kandidat001497,Morten Fraas,2007,osby,62,34,Ikke valgt,0,1,1466,0.54,Oslo Byaksjon,1,2007-09-10,2,8.07621704557839e-15,0,34,34
kandidat001498,Morten G. Edvardsen,2011,sp,11,28,Ikke valgt,22,16,1591,0.51,Senterpartiet,38,2011-09-12,6,0.00301846418978471,0,6,6
kandidat001499,Morten Georg Edvardsen,2015,sp,5,5,Ikke valgt,54,28,1926,0.6,Senterpartiet,82,2015-09-14,3,5.84710387243132e-11,0,8,8
kandidat001500,Morten Grinna Normann,2015,v,13,12,Ikke valgt,287,63,21986,6.86,Venstre,350,2015-09-14,22,1.57535529915316,2,91,89
kandidat001501,Morten Haugerud,2007,mdg,43,41,Ikke valgt,6,2,1687,0.62,Miljøpartiet De Grønne,8,2007-09-10,9,1.89295868909517,3,22,19
kandidat001502,Morten Lund,2007,sp,44,47,Ikke valgt,7,1,2189,0.81,Senterpartiet,8,2007-09-10,1945,37.6951124445463,69,4028,3959
kandidat001503,Morten Lund,2011,sp,25,41,Ikke valgt,12,3,1591,0.51,Senterpartiet,15,2011-09-12,1294,28.4256741175893,63,5322,5259
kandidat001504,Morten Lundstein,2007,sp,20,21,Ikke valgt,10,16,2189,0.81,Senterpartiet,26,2007-09-10,5,0.109967392842741,0,8,8
kandidat001505,Morten Lundstein,2011,sp,50,42,Ikke valgt,5,2,1591,0.51,Senterpartiet,7,2011-09-12,9,0.0394838221575957,0,17,17
kandidat001506,Morten Lundstein,2015,sp,7,8,Ikke valgt,62,9,1926,0.6,Senterpartiet,71,2015-09-14,7,1.68322787494014,2,24,22
kandidat001507,Morten Magelssen,2015,krf,33,40,Ikke valgt,81,3,7827,2.44,Kristelig Folkeparti,84,2015-09-14,236,1.49639556889794,5,279,274
kandidat001508,Morten R. Ednes,2007,osby,47,37,Ikke valgt,6,4,1466,0.54,Oslo Byaksjon,10,NA,0,0,0,0,0
kandidat001509,Morten Schau,2007,sv,41,26,Ikke valgt,142,11,28701,10.56,Sosialistisk Venstreparti,153,2007-09-10,769,11.843996942114,18,1013,995
kandidat001510,Morten Søberg,2007,sp,46,35,Ikke valgt,7,0,2189,0.81,Senterpartiet,7,2007-09-10,23,0.0547912164513787,0,40,40
kandidat001511,Morten Søberg,2011,sp,35,50,Ikke valgt,9,2,1591,0.51,Senterpartiet,11,2011-09-12,485,11.7697533841807,22,525,503
kandidat001512,Morten Søberg,2015,sp,39,47,Ikke valgt,13,3,1926,0.6,Senterpartiet,16,2015-09-14,616,7.83890661280239,19,1141,1122
kandidat001513,Morten Steenstrup,2015,h,16,17,Valgt,1367,42,101882,31.8,Høyre,1409,2015-09-14,285,5.65289518249839,17,3163,3146
kandidat001514,Morten Svendsen,2015,rv,65,57,Ikke valgt,38,2,16174,5.05,Rødt,40,2015-09-14,539,29.6424718192216,81,2253,2172
kandidat001515,Morten Svensson,2007,mdg,15,11,Ikke valgt,26,6,1687,0.62,Miljøpartiet De Grønne,32,2007-09-10,2,1.43746883308965,2,10,8
kandidat001516,Morten Svensson,2011,mdg,42,29,Ikke valgt,34,5,7653,2.47,Miljøpartiet De Grønne,39,2011-09-12,30,0.620194544384299,1,40,39
kandidat001517,Morten Syversen,2011,krf,52,49,Ikke valgt,26,2,7571,2.44,Kristelig Folkeparti,28,2011-09-12,37,1.45023897417585,2,111,109
kandidat001518,Morten Wasstøl,2011,sv,45,36,Ikke valgt,95,8,19477,6.28,Sosialistisk Venstreparti,103,2011-09-12,497,1.63736386360181,2,1104,1102
kandidat001519,Moussa El-Hage,2007,in,3,2,Ikke valgt,52,22,329000,0.12,Innvandrerpartiet,74,2007-09-10,8,2.26170259620753,3,13,10
kandidat001520,Mubashar Kapur,2007,h,31,39,Vara,426,26,68475,25.19,Høyre,452,2007-09-10,17,6.59398730088017,15,19,4
kandidat001521,Mudassar Kapur,2011,h,10,8,Valgt,1219,57,110776,35.7,Høyre,1276,2011-09-12,237,6.18093953283329,8,245,237
kandidat001522,Munir Jaber,2015,ap,29,57,Vara,1545,92,102431,31.97,Arbeiderpartiet,1637,2015-09-14,456,4.9537090703276,10,461,451
kandidat001523,Nadeem Butt,2011,ap,4,10,Valgt,3354,128,102707,33.1,Det norske Arbeiderparti,3482,2011-09-12,440,8.72436417323043,12,1404,1392
kandidat001524,Nadeem Butt,2015,ap,22,25,Vara,2408,87,102431,31.97,Arbeiderpartiet,2495,2015-09-14,115,3.26187276682922,5,1519,1514
kandidat001525,Naima Abdirahman Aseyr,2015,rv,15,13,Ikke valgt,602,24,16174,5.05,Rødt,626,2015-09-14,12,5.19760080521007e-06,0,23,23
kandidat001526,Naomi Ichihara Røkkum,2011,v,12,12,Vara,371,22,25351,8.17,Venstre,393,2011-09-12,11,0.0189294002896239,0,12,12
kandidat001527,Naomi Ichihara Røkkum,2015,v,8,11,Vara,521,45,21986,6.86,Venstre,566,2015-09-14,21,0.212419194055608,1,33,32
kandidat001528,Nasir Ahmed,2011,ap,14,32,Valgt,2531,80,102707,33.1,Det norske Arbeiderparti,2611,2011-09-12,77,4.57126528488878,10,91,81
kandidat001529,Nasir Ahmed,2015,ap,19,29,Valgt,3126,91,102431,31.97,Arbeiderpartiet,3217,2015-09-14,198,4.91318711118656,8,289,281
kandidat001530,Nasser Fard,2007,ksp,2,2,Ikke valgt,10,14,158000,0.06,Kristent Samlingsparti,24,2007-09-10,3,0.339446459777226,1,6,5
kandidat001531,Natasza P. Sandbu,2011,v,56,55,Ikke valgt,60,2,25351,8.17,Venstre,62,2011-09-12,19,0.00102869344296631,0,574,574
kandidat001532,Nawaz Rashid,2011,ap,24,42,Vara,1107,16,102707,33.1,Det norske Arbeiderparti,1123,2011-09-12,1,3.06416896290963e-15,0,2,2
kandidat001533,Nazneen Khan-Østrem,2007,osby,13,22,Ikke valgt,70,49,1466,0.54,Oslo Byaksjon,119,2007-09-10,159,1.42437447922377,5,159,154
kandidat001534,Negar Enayati,2007,rv,3,3,Valgt,714,186,14131,5.2,Rød Valgallianse,900,2007-09-10,10,6.13791203619447,7,10,3
kandidat001535,Negar Enayati,2011,rv,23,13,Ikke valgt,128,15,11257,3.63,Rødt,143,2011-09-12,35,1.11331899245527,2,45,43
kandidat001536,Negar Enayati,2015,rv,3,2,Valgt,806,218,16174,5.05,Rødt,1024,2015-09-14,46,1.53757612243716,3,91,88
kandidat001537,Nelly Delia Lanz Ramirez,2007,rv,22,22,Ikke valgt,141,8,14131,5.2,Rød Valgallianse,149,NA,0,0,0,0,0
kandidat001538,Nelly D. Lanz Ramirez,2011,rv,34,33,Ikke valgt,84,5,11257,3.63,Rødt,89,NA,0,0,0,0,0
kandidat001539,Nicolai Øyen Langfeldt,2015,h,23,38,Vara,813,75,101882,31.8,Høyre,888,2015-09-14,35,4.42115532380492,5,36,31
kandidat001540,Nikolai Buer,2015,lib,5,6,Ikke valgt,39,7,458,0.14,Liberalistene Oslo,46,2015-09-14,13,1.62704581696088,7,16,9
kandidat001541,Nikolai Dragnes,2007,mdg,38,35,Ikke valgt,6,4,1687,0.62,Miljøpartiet De Grønne,10,NA,0,0,0,0,0
kandidat001542,Nils Amund Raknerud,2011,rv,61,59,Ikke valgt,33,1,11257,3.63,Rødt,34,2011-09-12,16,0.00210998717108856,0,41,41
kandidat001543,Nils Heggemsnes,2011,krf,55,36,Ikke valgt,21,0,7571,2.44,Kristelig Folkeparti,21,2011-09-12,62,0.000298541983374903,0,77,77
kandidat001544,Nils-Petter Komperud,2011,frp,32,32,Ikke valgt,109,3,21852,7.04,Fremskrittspartiet,112,2011-09-12,17,1.60330662257575,2,20,18
kandidat001545,Nina Ansteinsson,2007,v,41,21,Ikke valgt,158,7,23703,8.72,Venstre,165,2007-09-10,1,0.000188012896327561,0,1,1
kandidat001546,Nina Bachke,2007,ap,2,2,Valgt,7677,596,81265,29.89,Det norske Arbeiderparti,8273,2007-09-10,431,139.862651866037,223,467,244
kandidat001547,Nina Bachke,2011,ap,9,9,Valgt,2206,75,102707,33.1,Det norske Arbeiderparti,2281,2011-09-12,666,3.17951782052837,4,1133,1129
kandidat001548,Nina Brekkli,2011,mdg,61,50,Ikke valgt,17,1,7653,2.47,Miljøpartiet De Grønne,18,NA,0,0,0,0,0
kandidat001549,Nina Dessau,2011,mdg,5,6,Vara,226,56,7653,2.47,Miljøpartiet De Grønne,282,2011-09-12,77,0.858072368348886,4,314,310
kandidat001550,Nina Lauritzsen,2015,frp,19,15,Ikke valgt,181,19,19311,6.03,Fremskrittspartiet,200,NA,0,0,0,0,0
kandidat001551,Nina Stanghov Ulstein,2011,h,63,61,Ikke valgt,228,3,110776,35.7,Høyre,231,2011-09-12,43,0.000179569520093277,0,43,43
kandidat001552,Nina Witoszek,2015,mdg,15,61,Ikke valgt,508,61,26096,8.14,Miljøpartiet De Grønne,569,2015-09-14,675,14.1653330045163,54,1788,1734
kandidat001553,Nolvia Dominguez Skjetne,2007,sv,19,18,Ikke valgt,425,34,28701,10.56,Sosialistisk Venstreparti,459,2007-09-10,5,3.1601709293044e-07,0,57,57
kandidat001554,Nora Elisabeth Fjelddalen,2015,sv,30,54,Ikke valgt,212,9,17445,5.44,Sosialistisk Venstreparti,221,NA,0,0,0,0,0
kandidat001555,Nora Krogh,2011,sv,12,17,Ikke valgt,377,46,19477,6.28,Sosialistisk Venstreparti,423,2011-09-12,1,1.06619437639816e-07,0,5,5
kandidat001556,Nora Olafsdatter Krogh,2007,sv,23,20,Ikke valgt,378,15,28701,10.56,Sosialistisk Venstreparti,393,2007-09-10,5,0.00344140862586081,0,8,8
kandidat001557,Norvald Lyngstadaas,2007,sp,43,45,Ikke valgt,5,3,2189,0.81,Senterpartiet,8,2007-09-10,2,0.0103290476540531,0,149,149
kandidat001558,Norvald Lyngstadaas,2011,sp,49,43,Ikke valgt,7,1,1591,0.51,Senterpartiet,8,2011-09-12,2,0.0030184628406133,0,151,151
kandidat001559,Oddbjørg Minos,2007,krf,6,16,Vara,196,20,8368,3.08,Kristelig Folkeparti,216,2007-09-10,1,7.70674293084751e-07,0,1,1
kandidat001560,Oddbjørg Minos,2011,krf,4,3,Vara,345,50,7571,2.44,Kristelig Folkeparti,395,2011-09-12,18,1.18347705672684,2,19,17
kandidat001561,Oddbjørg Minos,2015,krf,2,2,Vara,1187,231,7827,2.44,Kristelig Folkeparti,1418,2015-09-14,57,13.6456474813938,17,76,59
kandidat001562,Odd Einar Dørum,2007,v,7,62,Vara,962,142,23703,8.72,Venstre,1104,2007-09-10,17397,347.303462282436,744,31912,31168
kandidat001563,Odd Einar Dørum,2011,v,2,3,Valgt,3385,1019,25351,8.17,Venstre,4404,2011-09-12,7995,231.64567101393,405,39907,39502
kandidat001564,Odd Einar Dørum,2015,v,5,6,Vara,1710,520,21986,6.86,Venstre,2230,2015-09-14,3455,77.3772407867872,122,43362,43240
kandidat001565,Odd Fidje,2011,krf,25,31,Ikke valgt,101,7,7571,2.44,Kristelig Folkeparti,108,2011-09-12,1,1.17499728498973e-09,0,4,4
kandidat001566,Odd Sætre,2007,dem,3,3,Ikke valgt,15,9,306000,0.11,Demokratene,24,2007-09-10,17,0.206205303892134,1,39,38
kandidat001567,Oddvar Aall Larsen,2007,dem,52,44,Ikke valgt,0,0,306000,0.11,Demokratene,0,2007-09-10,56,0.436986233126371,2,70,68
kandidat001568,Oddvar Hatlehol,2007,krf,27,37,Ikke valgt,59,1,8368,3.08,Kristelig Folkeparti,60,2007-09-10,5,3.47986884049366e-10,0,14,14
kandidat001569,Oddvar Hatlehol,2011,krf,16,21,Ikke valgt,142,2,7571,2.44,Kristelig Folkeparti,144,2011-09-12,6,0.977271249321927,1,20,19
kandidat001570,Oddvar Hatlehol,2015,krf,12,12,Ikke valgt,148,14,7827,2.44,Kristelig Folkeparti,162,2015-09-14,7,4.46943786632895e-07,0,27,27
kandidat001571,Øifryd Sandra Gaup,2011,dem,23,13,Ikke valgt,2,0,214000,0.07,Demokratene i Norge,2,NA,0,0,0,0,0
kandidat001572,Øistein Ness,2007,pp,14,15,Ikke valgt,8,4,1414,0.52,Pensjonistpartiet,12,NA,0,0,0,0,0
kandidat001573,Øistein Østtveit Svelle,2015,v,51,55,Ikke valgt,83,14,21986,6.86,Venstre,97,2015-09-14,1,2.47198412074644e-12,0,5,5
kandidat001574,Øivind A Tandberg,2015,h,40,52,Vara,461,37,101882,31.8,Høyre,498,2015-09-14,37,3.67904189977134,6,1038,1032
kandidat001575,Øivind A. Tandberg,2011,h,64,59,Ikke valgt,220,8,110776,35.7,Høyre,228,2011-09-12,222,1.00985947504222,1,1001,1000
kandidat001576,Øivinn Wang,2007,krf,58,58,Ikke valgt,22,2,8368,3.08,Kristelig Folkeparti,24,2007-09-10,14,1.81515212567146,3,36,33
kandidat001577,Ola Elvestuen,2007,v,2,1,Valgt,3031,819,23703,8.72,Venstre,3850,2007-09-10,1764,304.925008908062,444,1925,1481
kandidat001578,Ola Elvestuen,2011,v,1,1,Valgt,3850,1032,25351,8.17,Venstre,4882,2011-09-12,8954,792.066105497531,1131,10879,9748
kandidat001579,Olaf Svorstøl,2007,rv,16,27,Ikke valgt,233,19,14131,5.2,Rød Valgallianse,252,2007-09-10,76,1.70391053354483,4,171,167
kandidat001580,Olaf Svorstøl,2011,rv,19,14,Ikke valgt,165,27,11257,3.63,Rødt,192,2011-09-12,150,3.30238250410309,4,321,317
kandidat001581,Olaf Svorstøl,2015,rv,24,27,Ikke valgt,162,22,16174,5.05,Rødt,184,2015-09-14,22,0.483220647386602,1,343,342
kandidat001582,Olaf Thommessen,2007,v,1,5,Valgt,3741,1005,23703,8.72,Venstre,4746,2007-09-10,3909,260.372916324652,580,4245,3665
kandidat001583,Ola Kvisgaard,2007,h,18,42,Vara,663,107,68475,25.19,Høyre,770,2007-09-10,69,2.2172697003397,4,73,69
kandidat001584,Ola Kvisgaard,2011,h,18,36,Valgt,879,83,110776,35.7,Høyre,962,2011-09-12,44,8.75917697333053,16,117,101
kandidat001585,Ola Kvisgaard,2015,h,15,11,Valgt,1336,91,101882,31.8,Høyre,1427,2015-09-14,118,8.4218614700022,17,235,218
kandidat001586,Ola Sendstad,2015,sp,28,31,Ikke valgt,14,7,1926,0.6,Senterpartiet,21,2015-09-14,34,0.0982836389134994,1,41,40
kandidat001587,Ola Skaalvik Elvevold,2015,sv,38,26,Ikke valgt,159,18,17445,5.44,Sosialistisk Venstreparti,177,2015-09-14,198,0.0225186368128229,0,2407,2407
kandidat001588,Olav Aarrestad,2007,nkp,16,15,Ikke valgt,7,1,203000,0.07,Norges Kommunistiske Parti,8,2007-09-10,18,0.015125573330907,0,30,30
kandidat001589,Olav Mo Grimdalen,2015,ksp,9,6,Ikke valgt,16,3,421,0.13,Partiet De Kristne,19,2015-09-14,2,0.00527910768239745,0,2,2
kandidat001590,Olav Tønsberg,2011,ap,26,20,Vara,1052,43,102707,33.1,Det norske Arbeiderparti,1095,2011-09-12,26,3.73985361105398,4,102,98
kandidat001591,Ole Andreas Gjerull,2007,krf,54,34,Ikke valgt,24,0,8368,3.08,Kristelig Folkeparti,24,2007-09-10,1,0.0428092961590964,0,3,3
kandidat001592,Ole Andre Karlson,2015,sp,42,40,Ikke valgt,14,0,1926,0.6,Senterpartiet,14,2015-09-14,4,2.29569967465697,3,4,1
kandidat001593,Ole A. Werring,2007,v,23,13,Ikke valgt,239,27,23703,8.72,Venstre,266,2007-09-10,26,0.879403057080594,1,30,29
kandidat001594,Ole Jacob Bull,2007,osby,30,31,Ikke valgt,10,12,1466,0.54,Oslo Byaksjon,22,2007-09-10,257,8.62352518005132,38,518,480
kandidat001595,Ole Kristian Eivindson,2007,krf,14,29,Ikke valgt,69,25,8368,3.08,Kristelig Folkeparti,94,2007-09-10,8,2.39041361726298,3,9,6
kandidat001596,Ole Martin Moen,2007,dlf,2,3,Ikke valgt,10,0,127000,0.05,Det Liberale Folkepartiet,10,2007-09-10,29,0.0536943078027701,0,32,32
kandidat001597,Ole Martin Moen,2011,dlf,2,3,Ikke valgt,17,10,247000,0.08,Det Liberale Folkepartiet,27,2011-09-12,36,2.56252984252026,5,68,63
kandidat001598,Ole Petter Drevland,2007,kp,20,13,Ikke valgt,0,2,120000,0.04,Kystpartiet,2,2007-09-10,814,53.0375198638347,247,1039,792
kandidat001599,Olivia Corso Salles,2015,sv,25,53,Ikke valgt,223,21,17445,5.44,Sosialistisk Venstreparti,244,2015-09-14,166,0.0165342732290748,0,172,172
kandidat001600,Olivia Salles,2011,sv,17,35,Ikke valgt,269,24,19477,6.28,Sosialistisk Venstreparti,293,2011-09-12,26,0.0141874805602736,0,43,43
kandidat001601,Ombir Upadhyay,2011,frp,15,24,Ikke valgt,207,16,21852,7.04,Fremskrittspartiet,223,2011-09-12,42,1.84810619654516,2,51,49
kandidat001602,Ombir Upadhyay,2015,frp,11,11,Vara,270,52,19311,6.03,Fremskrittspartiet,322,2015-09-14,45,1.16576373780402,3,96,93
kandidat001603,Ottar Lystad,2015,sp,16,12,Ikke valgt,35,5,1926,0.6,Senterpartiet,40,NA,0,0,0,0,0
kandidat001604,Ouarda Jannaouni,2015,frp,25,13,Ikke valgt,136,13,19311,6.03,Fremskrittspartiet,149,2015-09-14,15,2.00000007402575,2,15,13
kandidat001605,Ove Reidulff,2007,dem,47,27,Ikke valgt,0,0,306000,0.11,Demokratene,0,NA,0,0,0,0,0
kandidat001606,Ove Reidulff,2011,dem,28,20,Ikke valgt,1,0,214000,0.07,Demokratene i Norge,1,NA,0,0,0,0,0
kandidat001607,Øystein Andre Lægdene,2011,h,51,39,Ikke valgt,350,31,110776,35.7,Høyre,381,2011-09-12,4,0.0254769559516565,0,5,5
kandidat001608,Øystein Eriksen Søreide,2011,h,46,58,Vara,386,25,110776,35.7,Høyre,411,2011-09-12,228,0.593369905574635,3,252,249
kandidat001609,Øystein Eriksen Søreide,2015,h,5,10,Valgt,1863,65,101882,31.8,Høyre,1928,2015-09-14,801,31.4351088811169,64,1053,989
kandidat001610,Øystein Fossen,2007,osby,51,24,Ikke valgt,6,3,1466,0.54,Oslo Byaksjon,9,2007-09-10,13,0.248261707784384,1,29,28
kandidat001611,Øystein G. Sjøtveit,2011,frp,3,2,Valgt,556,42,21852,7.04,Fremskrittspartiet,598,2011-09-12,72,1.0436376418424,1,140,139
kandidat001612,Øystein Jakobsen,2015,pirat,1,1,Ikke valgt,137,145,805,0.25,Piratpartiet,282,2015-09-14,299,3.75752575087922,9,446,437
kandidat001613,Øystein Middelthun,2015,pirat,4,5,Ikke valgt,49,12,805,0.25,Piratpartiet,61,2015-09-14,73,0.0259192951450564,0,73,73
kandidat001614,Øystein Rikheim Sundelin,2015,h,9,8,Valgt,1335,39,101882,31.8,Høyre,1374,2015-09-14,24,0.395360458815526,2,30,28
kandidat001615,Øystein Røysland Sørlie,2015,pirat,17,15,Ikke valgt,17,7,805,0.25,Piratpartiet,24,NA,0,0,0,0,0
kandidat001616,Øystein R. Sundelin,2007,h,10,9,Valgt,1317,44,68475,25.19,Høyre,1361,2007-09-10,22,2.66243441496219,3,23,20
kandidat001617,Øystein R. Sundelin,2011,h,8,10,Valgt,1315,43,110776,35.7,Høyre,1358,2011-09-12,14,0.0636050461329423,0,37,37
kandidat001618,Øystein Sjøtveit,2015,frp,6,5,Vara,415,63,19311,6.03,Fremskrittspartiet,478,2015-09-14,573,2.85080244279915,4,1125,1121
kandidat001619,Øyvind Andreas Meland,2007,dem,28,28,Ikke valgt,1,1,306000,0.11,Demokratene,2,NA,0,0,0,0,0
kandidat001620,Øyvind Eggen,2015,v,36,26,Ikke valgt,102,36,21986,6.86,Venstre,138,2015-09-14,282,10.5512283600393,25,454,429
kandidat001621,Øyvind Michelsen,2007,frp,29,26,Ikke valgt,169,10,38873,14.3,Fremskrittspartiet,179,2007-09-10,34,0.195575253797449,1,58,57
kandidat001622,Øyvind Norby Bjørgo,2011,v,23,25,Ikke valgt,198,11,25351,8.17,Venstre,209,2011-09-12,3,0.0780999414151361,0,3,3
kandidat001623,Øyvind Såtvedt,2007,h,51,57,Ikke valgt,223,4,68475,25.19,Høyre,227,2007-09-10,48,5.07138216006726,9,109,100
kandidat001624,Øyvind Vea,2015,mdg,63,36,Ikke valgt,76,3,26096,8.14,Miljøpartiet De Grønne,79,2015-09-14,2,0.000375038116981814,0,5,5
kandidat001625,Pål Christian Roland,2007,krf,36,52,Ikke valgt,32,1,8368,3.08,Kristelig Folkeparti,33,2007-09-10,617,1.16526251136091,2,802,800
kandidat001626,Pål Erik Olsen,2007,osby,32,15,Ikke valgt,10,10,1466,0.54,Oslo Byaksjon,20,2007-09-10,6,0.0221181205568248,0,9,9
kandidat001627,Pål Hellesnes,2007,rv,44,34,Ikke valgt,47,3,14131,5.2,Rød Valgallianse,50,2007-09-10,236,0.345662137691993,0,256,256
kandidat001628,Pål Nygaard,2007,frp,24,27,Ikke valgt,215,7,38873,14.3,Fremskrittspartiet,222,2007-09-10,196,2.35710648296169,6,328,322
kandidat001629,Pål Thygesen,2015,mdg,9,6,Vara,646,120,26096,8.14,Miljøpartiet De Grønne,766,2015-09-14,56,1.89222325257831,5,107,102
kandidat001630,Patrik Sahlstrøm,2011,mdg,18,13,Ikke valgt,74,11,7653,2.47,Miljøpartiet De Grønne,85,NA,0,0,0,0,0
kandidat001631,Pawel Erlandsen,2015,sp,36,21,Ikke valgt,13,3,1926,0.6,Senterpartiet,16,NA,0,0,0,0,0
kandidat001632,Payao Prasannet,2011,ksp,8,8,Ikke valgt,8,1,235000,0.08,Kristent Samlingsparti,9,NA,0,0,0,0,0
kandidat001633,Peder Staubo,2015,frp,20,17,Ikke valgt,170,30,19311,6.03,Fremskrittspartiet,200,2015-09-14,6,2.6699892206094e-05,0,24,24
kandidat001634,Per Anders Langerød,2011,ap,22,28,Vara,1113,215,102707,33.1,Det norske Arbeiderparti,1328,2011-09-12,549,13.2023210776269,24,697,673
kandidat001635,Per Anders Langerød,2015,ap,28,19,Vara,1273,368,102431,31.97,Arbeiderpartiet,1641,2015-09-14,153,4.91491966056756,14,850,836
kandidat001636,Per Andre Deberitz,2007,dem,20,31,Ikke valgt,2,2,306000,0.11,Demokratene,4,NA,0,0,0,0,0
kandidat001637,Per Arne Flæsen,2011,kp,8,8,Ikke valgt,4,0,126000,0.04,Kystpartiet,4,NA,0,0,0,0,0
kandidat001638,Per Arne Flæsen,2015,kp,5,4,Ikke valgt,9,0,124,0.04,Kystpartiet,9,NA,0,0,0,0,0
kandidat001639,Per Arne Salo,2007,rv,53,45,Ikke valgt,38,0,14131,5.2,Rød Valgallianse,38,2007-09-10,18,1.67220265459445,4,65,61
kandidat001640,Per Arne Salo,2011,rv,39,32,Ikke valgt,65,6,11257,3.63,Rødt,71,2011-09-12,10,1.60798774748432,2,75,73
kandidat001641,Per Erik Johansen,2015,dem,6,8,Ikke valgt,46,1,740,0.23,Demokratene i Norge,47,2015-09-14,89,0.334937583340029,2,320,318
kandidat001642,Per-Erik Johansen,2011,dem,18,16,Ikke valgt,3,1,214000,0.07,Demokratene i Norge,4,2011-09-12,79,2.41215407181233,7,231,224
kandidat001643,Per Erling Hallangen,2007,pp,25,16,Ikke valgt,8,0,1414,0.52,Pensjonistpartiet,8,NA,0,0,0,0,0
kandidat001644,Per Gunnar Dahl,2007,ap,41,51,Ikke valgt,458,85,81265,29.89,Det norske Arbeiderparti,543,2007-09-10,57,5.03122321217883,10,74,64
kandidat001645,Per Gunnar Dahl,2011,ap,48,44,Ikke valgt,503,42,102707,33.1,Det norske Arbeiderparti,545,2011-09-12,38,1.45462011260944,6,112,106
kandidat001646,Per H. Christiansen,2011,h,44,19,Vara,441,11,110776,35.7,Høyre,452,2011-09-12,22,2.03453819118121,3,96,93
kandidat001647,Per-Johan B. Bogerud,2007,h,39,18,Ikke valgt,387,3,68475,25.19,Høyre,390,2007-09-10,14,0.916401894894832,1,21,20
kandidat001648,Per Kristian Nielsen,2007,krf,25,49,Ikke valgt,60,6,8368,3.08,Kristelig Folkeparti,66,2007-09-10,30,2.63279639301187,3,51,48
kandidat001649,Per Kristian Sbertoli,2011,krf,24,19,Ikke valgt,106,3,7571,2.44,Kristelig Folkeparti,109,2011-09-12,5,0.00478064276168691,0,5,5
kandidat001650,Per Kristian Sbertoli,2015,krf,34,50,Ikke valgt,64,6,7827,2.44,Kristelig Folkeparti,70,2015-09-14,83,1.00067928196365,2,88,86
kandidat001651,Per Leinad,2007,dem,32,38,Ikke valgt,2,0,306000,0.11,Demokratene,2,NA,0,0,0,0,0
kandidat001652,Per Magnar Arnstad,2007,sp,41,39,Ikke valgt,8,1,2189,0.81,Senterpartiet,9,2007-09-10,25,0.322351533016454,3,218,215
kandidat001653,Per Morten Klette,2007,h,61,40,Ikke valgt,175,3,68475,25.19,Høyre,178,2007-09-10,10,2.51130107723137,3,12,9
kandidat001654,Pernille Bjerkomp,2007,osby,38,41,Ikke valgt,6,9,1466,0.54,Oslo Byaksjon,15,NA,0,0,0,0,0
kandidat001655,Pernille Lindstad,2015,fi,24,28,Ikke valgt,28,3,1388,0.43,Feministisk Initiativ,31,2015-09-14,1,0,0,4,4
kandidat001656,Pernille Ødegård,2011,sv,19,27,Ikke valgt,234,23,19477,6.28,Sosialistisk Venstreparti,257,2011-09-12,15,0.000160648955914396,0,24,24
kandidat001657,Per Olaf Dahlen,2011,dem,10,12,Ikke valgt,6,1,214000,0.07,Demokratene i Norge,7,2011-09-12,1,1.39783619357725e-05,0,1,1
kandidat001658,Per Østvold,2011,sv,16,57,Ikke valgt,277,31,19477,6.28,Sosialistisk Venstreparti,308,2011-09-12,3666,24.8467733977631,55,10980,10925
kandidat001659,Per Otto Simon Hartmann,2011,pp,19,17,Ikke valgt,11,0,1045,0.34,Pensjonistpartiet,11,NA,0,0,0,0,0
kandidat001660,Per Otto Simon Hartmann,2015,pp,19,11,Ikke valgt,8,2,1169,0.36,Pensjonistpartiet,10,NA,0,0,0,0,0
kandidat001661,Per Platou Selvig,2007,osby,14,16,Ikke valgt,30,11,1466,0.54,Oslo Byaksjon,41,NA,0,0,0,0,0
kandidat001662,Per Roar Øgaard,2007,krf,63,63,Ikke valgt,18,2,8368,3.08,Kristelig Folkeparti,20,2007-09-10,2,1.6369077685701e-07,0,2,2
kandidat001663,Per Roar Øgaard,2011,krf,53,54,Ikke valgt,23,3,7571,2.44,Kristelig Folkeparti,26,2011-09-12,5,0.0528004375860262,0,7,7
kandidat001664,Per Steffen Borg,2007,dem,34,47,Ikke valgt,0,2,306000,0.11,Demokratene,2,NA,0,0,0,0,0
kandidat001665,Per-Trygve Hoff,2007,h,11,34,Valgt,1921,127,68475,25.19,Høyre,2048,2007-09-10,63,4.30900603351149,8,76,68
kandidat001666,Per-Trygve Hoff,2011,h,13,32,Valgt,1557,54,110776,35.7,Høyre,1611,2011-09-12,30,2.54229555922993,4,106,102
kandidat001667,Per-Trygve Hoff,2015,h,17,20,Valgt,1154,53,101882,31.8,Høyre,1207,2015-09-14,38,0.587019672811481,2,144,142
kandidat001668,Peter André Kristoffersen,2007,da,7,6,Ikke valgt,9,4,191000,0.07,Demokratisk Alternativ for Oslo,13,NA,0,0,0,0,0
kandidat001669,Peter E. Walseth,2007,krf,7,7,Vara,182,14,8368,3.08,Kristelig Folkeparti,196,NA,0,0,0,0,0
kandidat001670,Peter Hausken,2011,ap,62,56,Ikke valgt,289,8,102707,33.1,Det norske Arbeiderparti,297,2011-09-12,1,9.67466446761188e-06,0,8,8
kandidat001671,Peter Nils Sollie,2011,h,61,53,Ikke valgt,232,6,110776,35.7,Høyre,238,2011-09-12,1,0.977262483773277,1,1,0
kandidat001672,Peter N Myhre,2015,frp,4,8,Valgt,907,70,19311,6.03,Fremskrittspartiet,977,2015-09-14,1185,1.77316603182324,3,8636,8633
kandidat001673,Peter N. Myhre,2007,frp,2,2,Valgt,2987,215,38873,14.3,Fremskrittspartiet,3202,2007-09-10,2522,334.976076479525,517,4825,4308
kandidat001674,Peter Sollie,2007,h,62,54,Ikke valgt,171,3,68475,25.19,Høyre,174,2007-09-10,11,0.764861934082118,1,14,13
kandidat001675,Peter Sollie,2015,h,61,59,Ikke valgt,271,30,101882,31.8,Høyre,301,2015-09-14,16,0.721821045046488,1,38,37
kandidat001676,Petter Gjerull,2011,krf,45,33,Ikke valgt,42,3,7571,2.44,Kristelig Folkeparti,45,2011-09-12,3,1.16684018109515,2,9,7
kandidat001677,Petter Gjerull,2015,krf,35,30,Ikke valgt,52,6,7827,2.44,Kristelig Folkeparti,58,2015-09-14,4,0.000631286412895946,0,13,13
kandidat001678,Petter Haakenstad Godli,2015,sp,37,35,Ikke valgt,14,2,1926,0.6,Senterpartiet,16,2015-09-14,3,2.45905883196535e-09,0,13,13
kandidat001679,Petter Kaas,2007,dem,43,18,Ikke valgt,0,0,306000,0.11,Demokratene,0,2007-09-10,6,4.39076303747981e-09,0,7,7
kandidat001680,Petter Ødegaard,2007,dem,38,42,Ikke valgt,1,0,306000,0.11,Demokratene,1,2007-09-10,21,1.87465158111134,4,180,176
kandidat001681,Pia Farstad,2011,h,22,24,Valgt,812,27,110776,35.7,Høyre,839,2011-09-12,192,12.9374993961696,33,463,430
kandidat001682,Pia Farstad von Hall,2015,h,7,6,Valgt,1590,42,101882,31.8,Høyre,1632,2015-09-14,222,10.0845649766406,27,222,195
kandidat001683,Pia Gjesme Holm,2011,ap,57,43,Ikke valgt,392,13,102707,33.1,Det norske Arbeiderparti,405,2011-09-12,32,0.658261283983812,0,36,36
kandidat001684,Pia Gjesme Holm,2015,ap,62,63,Ikke valgt,498,8,102431,31.97,Arbeiderpartiet,506,2015-09-14,12,0.000742342129372411,0,48,48
kandidat001685,Prableen Kaur,2011,ap,11,23,Valgt,3340,516,102707,33.1,Det norske Arbeiderparti,3856,2011-09-12,317,120.552673222503,254,317,63
kandidat001686,Prableen Kaur,2015,ap,17,26,Valgt,3143,314,102431,31.97,Arbeiderpartiet,3457,2015-09-14,1303,5.986483643447,11,1620,1609
kandidat001687,Premaraja Thangavel,2011,sv,39,50,Ikke valgt,125,16,19477,6.28,Sosialistisk Venstreparti,141,2011-09-12,1,0.977262483773277,1,1,0
kandidat001688,Qaman Kalif Musse,2011,sp,32,44,Ikke valgt,9,4,1591,0.51,Senterpartiet,13,2011-09-12,3,0.0542761431618943,0,4,4
kandidat001689,Qaman Kalif Musse,2015,sp,34,26,Ikke valgt,16,1,1926,0.6,Senterpartiet,17,2015-09-14,3,1.53528092422346,2,7,5
kandidat001690,Ragna Fjeld,2015,fi,23,18,Ikke valgt,24,7,1388,0.43,Feministisk Initiativ,31,2015-09-14,9,0.00180492344948392,0,15,15
kandidat001691,Ragna Kronstad,2007,osby,26,21,Ikke valgt,13,12,1466,0.54,Oslo Byaksjon,25,2007-09-10,169,0.228245851233106,1,376,375
kandidat001692,Ragnar Kvåle,2007,sp,19,18,Ikke valgt,21,5,2189,0.81,Senterpartiet,26,2007-09-10,70,1.49844393494316,2,94,92
kandidat001693,Ragnar Kvåle,2015,sp,41,37,Ikke valgt,13,1,1926,0.6,Senterpartiet,14,2015-09-14,293,0.201415952806752,1,515,514
kandidat001694,Ragnar Leine,2007,rv,54,49,Ikke valgt,29,8,14131,5.2,Rød Valgallianse,37,2007-09-10,17,1.40337464769549,2,37,35
kandidat001695,Ragnar Leine,2011,rv,10,8,Ikke valgt,183,24,11257,3.63,Rødt,207,2011-09-12,43,3.79440959868085,4,80,76
kandidat001696,Ragnar Skjøld,2015,v,65,52,Ikke valgt,37,4,21986,6.86,Venstre,41,2015-09-14,38,11.2271452493134,28,50,22
kandidat001697,Ragnhild Heitmann Kaas,2007,dem,16,6,Ikke valgt,4,0,306000,0.11,Demokratene,4,NA,0,0,0,0,0
kandidat001698,Ragnhild Iversen,2011,mdg,62,54,Ikke valgt,15,3,7653,2.47,Miljøpartiet De Grønne,18,2011-09-12,31,1.09043415930624,2,106,104
kandidat001699,Ragnhild Laird Iversen,2015,mdg,47,51,Ikke valgt,130,12,26096,8.14,Miljøpartiet De Grønne,142,2015-09-14,5,1.46402764991779e-14,0,5,5
kandidat001700,Ragnhild Marie Pedersen,2011,mdg,59,42,Ikke valgt,21,1,7653,2.47,Miljøpartiet De Grønne,22,2011-09-12,2,4.85733426590173e-05,0,8,8
kandidat001701,Ragnhild Ouren,2011,v,45,53,Ikke valgt,78,13,25351,8.17,Venstre,91,2011-09-12,2,4.42732579005695e-12,0,5,5
kandidat001702,Rameen Najam Sheikh,2015,rv,20,11,Ikke valgt,233,47,16174,5.05,Rødt,280,2015-09-14,4,2.77362304006948,4,4,0
kandidat001703,Randi Birkeland,2015,krf,17,17,Ikke valgt,120,15,7827,2.44,Kristelig Folkeparti,135,2015-09-14,53,5.41854752943685,10,138,128
kandidat001704,Randi Færevik,2011,rv,53,57,Ikke valgt,47,2,11257,3.63,Rødt,49,2011-09-12,9,0.0930939347838387,0,21,21
kandidat001705,Randi Marie Hoem,2011,v,54,39,Ikke valgt,64,6,25351,8.17,Venstre,70,2011-09-12,7,1.594192308038,2,10,8
kandidat001706,Randi Olsen,2011,v,47,52,Ikke valgt,84,6,25351,8.17,Venstre,90,2011-09-12,542,8.46618517671451,19,911,892
kandidat001707,Randi Røvik,2007,sv,28,24,Ikke valgt,244,13,28701,10.56,Sosialistisk Venstreparti,257,2007-09-10,21,4.63185610113845,5,34,29
kandidat001708,Randi Røvik,2011,sv,47,41,Ikke valgt,84,6,19477,6.28,Sosialistisk Venstreparti,90,2011-09-12,123,1.71279348346803,6,157,151
kandidat001709,Rannveig Dahle,2015,sv,43,39,Ikke valgt,121,10,17445,5.44,Sosialistisk Venstreparti,131,2015-09-14,12,0.00273679907071936,0,115,115
kandidat001710,Raphael Nechatini Koyuncu,2007,in,10,4,Ikke valgt,32,13,329000,0.12,Innvandrerpartiet,45,NA,0,0,0,0,0
kandidat001711,Rasmus Reinvang,2015,mdg,20,14,Ikke valgt,347,38,26096,8.14,Miljøpartiet De Grønne,385,2015-09-14,47,3.07432153468536,3,400,397
kandidat001712,Raymond Johansen,2015,ap,1,1,Valgt,21812,1499,102431,31.97,Arbeiderpartiet,23311,2015-09-14,24662,1051.0426337198,1806,52352,50546
kandidat001713,Raymond Thorsen,2007,dlf,7,6,Ikke valgt,3,2,127000,0.05,Det Liberale Folkepartiet,5,2007-09-10,53,2.51949163250579,7,122,115
kandidat001714,Reidar Bjørn-Larsen,2007,pp,26,27,Ikke valgt,8,0,1414,0.52,Pensjonistpartiet,8,2007-09-10,9,0.211159442051101,0,47,47
kandidat001715,Reidun Synnøve Sarre,2015,pp,6,21,Ikke valgt,20,5,1169,0.36,Pensjonistpartiet,25,NA,0,0,0,0,0
kandidat001716,Remi Padoin,2011,frp,40,47,Ikke valgt,77,15,21852,7.04,Fremskrittspartiet,92,2011-09-12,12,0.211540577954889,1,18,17
kandidat001717,Remi Schrøder Padoin,2007,frp,38,22,Ikke valgt,134,20,38873,14.3,Fremskrittspartiet,154,2007-09-10,2,0.00197808361151114,0,2,2
kandidat001718,Renate Johansen,2007,h,53,38,Ikke valgt,209,10,68475,25.19,Høyre,219,2007-09-10,73,5.44109480779166,13,113,100
kandidat001719,Renie Benedikte Engeseth,2015,rv,63,48,Ikke valgt,56,2,16174,5.05,Rødt,58,NA,0,0,0,0,0
kandidat001720,Reza Rezaee,2011,rv,2,3,Valgt,1007,338,11257,3.63,Rødt,1345,2011-09-12,354,29.5382351166068,41,1025,984
kandidat001721,Richard Andreassen,2011,dlf,8,10,Ikke valgt,7,0,247000,0.08,Det Liberale Folkepartiet,7,2011-09-12,220,10.1657076994039,24,471,447
kandidat001722,Richard T. K. Dahl,2007,ksp,6,7,Ikke valgt,7,3,158000,0.06,Kristent Samlingsparti,10,NA,0,0,0,0,0
kandidat001723,Rina Mariann Hansen,2007,ap,6,6,Valgt,2037,55,81265,29.89,Det norske Arbeiderparti,2092,2007-09-10,254,12.6685089768053,19,307,288
kandidat001724,Rina Mariann Hansen,2011,ap,5,3,Valgt,2679,119,102707,33.1,Det norske Arbeiderparti,2798,2011-09-12,629,29.4066878133988,50,936,886
kandidat001725,Rina Mariann Hansen,2015,ap,5,3,Valgt,2968,108,102431,31.97,Arbeiderpartiet,3076,2015-09-14,1482,14.3642049681522,37,2418,2381
kandidat001726,Risten Ravna Heatta,2007,sv,35,33,Ikke valgt,173,12,28701,10.56,Sosialistisk Venstreparti,185,2007-09-10,5,1.04296950910359,5,5,0
kandidat001727,Roald Ribe,2015,lib,2,2,Ikke valgt,70,15,458,0.14,Liberalistene Oslo,85,2015-09-14,10,1.2656233888932,3,16,13
kandidat001728,Roald Vedal,2007,kp,41,45,Ikke valgt,1,0,120000,0.04,Kystpartiet,1,NA,0,0,0,0,0
kandidat001729,Roar Ellingvåg,2007,rv,6,4,Vara,356,70,14131,5.2,Rød Valgallianse,426,2007-09-10,10,0.000951347206703682,0,23,23
kandidat001730,Roar Ellingvåg,2011,rv,54,25,Ikke valgt,44,3,11257,3.63,Rødt,47,2011-09-12,2,2.02488024285236e-06,0,25,25
kandidat001731,Robert Erlandsen,2011,krf,29,30,Ikke valgt,72,7,7571,2.44,Kristelig Folkeparti,79,2011-09-12,44,1.80266324177127,2,106,104
kandidat001732,Robert Haugen,2015,fi,15,17,Ikke valgt,35,7,1388,0.43,Feministisk Initiativ,42,2015-09-14,316,23.2697524465854,55,638,583
kandidat001733,Robert Wennerstrøm,2011,frp,42,44,Ikke valgt,73,5,21852,7.04,Fremskrittspartiet,78,2011-09-12,2,0.625486871443026,1,3,2
kandidat001734,Robert Wright,2011,krf,14,53,Ikke valgt,127,28,7571,2.44,Kristelig Folkeparti,155,2011-09-12,316,18.163639442864,44,1163,1119
kandidat001735,Robert Wright,2015,krf,29,56,Ikke valgt,88,14,7827,2.44,Kristelig Folkeparti,102,2015-09-14,676,39.4702181454477,65,1839,1774
kandidat001736,Robin Utnes Bergseth,2011,nkp,13,6,Ikke valgt,8,2,210000,0.07,Norges Kommunistiske Parti,10,NA,0,0,0,0,0
kandidat001737,Roger Håkon Skår,2007,osby,46,25,Ikke valgt,6,4,1466,0.54,Oslo Byaksjon,10,NA,0,0,0,0,0
kandidat001738,Rogerio Snarli,2007,dem,24,14,Ikke valgt,2,0,306000,0.11,Demokratene,2,NA,0,0,0,0,0
kandidat001739,Roger Pihl,2007,mdg,58,39,Ikke valgt,3,1,1687,0.62,Miljøpartiet De Grønne,4,2007-09-10,148,9.93272347535952,58,148,90
kandidat001740,Roja Darian,2011,ap,42,61,Vara,631,20,102707,33.1,Det norske Arbeiderparti,651,2011-09-12,3,1.98027533944495e-05,0,3,3
kandidat001741,Roja Darian,2015,ap,38,16,Vara,1183,38,102431,31.97,Arbeiderpartiet,1221,2015-09-14,15,0.762901242514506,1,18,17
kandidat001742,Rolf Andreas Vestvik,2015,sv,52,42,Ikke valgt,67,4,17445,5.44,Sosialistisk Venstreparti,71,2015-09-14,7,0.209305479246773,1,12,11
kandidat001743,Rolf Johan Grieg-Halvorsen,2007,v,42,35,Ikke valgt,151,14,23703,8.72,Venstre,165,2007-09-10,9,0.401245054381264,2,10,8
kandidat001744,Rolf Pedersen,2015,dem,3,3,Ikke valgt,67,3,740,0.23,Demokratene i Norge,70,2015-09-14,664,15.0562018771572,24,2520,2496
kandidat001745,Rolf Valle,2015,sp,15,20,Ikke valgt,25,17,1926,0.6,Senterpartiet,42,2015-09-14,9,0.989335584078694,3,24,21
kandidat001746,Rose Eleni Pålerud,2011,mdg,63,56,Ikke valgt,16,1,7653,2.47,Miljøpartiet De Grønne,17,NA,0,0,0,0,0
kandidat001747,Roy Greiner,2007,sfp,16,12,Ikke valgt,5,0,129000,0.05,Samfunnspartiet,5,NA,0,0,0,0,0
kandidat001748,Roy Gulbrandsen,2007,kp,21,18,Ikke valgt,2,0,120000,0.04,Kystpartiet,2,2007-09-10,5,0.343652788966654,2,21,19
kandidat001749,Roy Gulbrandsen,2015,kp,8,8,Ikke valgt,7,1,124,0.04,Kystpartiet,8,2015-09-14,37,4.42010065008077,5,80,75
kandidat001750,Roy Hammerø,2011,frp,23,20,Ikke valgt,124,8,21852,7.04,Fremskrittspartiet,132,2011-09-12,27,0.44460203939105,0,42,42
kandidat001751,Roy Reiersen,2007,pp,22,20,Ikke valgt,9,0,1414,0.52,Pensjonistpartiet,9,NA,0,0,0,0,0
kandidat001752,Roy Sørensen,2007,frp,47,47,Ikke valgt,105,2,38873,14.3,Fremskrittspartiet,107,2007-09-10,19,2.89252968977447,4,119,115
kandidat001753,Runa Fjellanger,2011,rv,41,43,Ikke valgt,62,8,11257,3.63,Rødt,70,2011-09-12,14,2.050921042851,4,19,15
kandidat001754,Runar Døving,2007,osby,3,6,Ikke valgt,85,80,1466,0.54,Oslo Byaksjon,165,2007-09-10,910,16.0266453400655,34,1174,1140
kandidat001755,Runar Hodne,2007,osby,33,32,Ikke valgt,11,8,1466,0.54,Oslo Byaksjon,19,2007-09-10,374,23.2204445348738,40,614,574
kandidat001756,Rune Aale-Hansen,2011,h,47,65,Vara,367,39,110776,35.7,Høyre,406,2011-09-12,299,6.16584864893797,11,614,603
kandidat001757,Rune Foshaug,2007,osby,39,13,Ikke valgt,8,6,1466,0.54,Oslo Byaksjon,14,2007-09-10,47,2.04018093226397,7,51,44
kandidat001758,Rune Gerhardsen,2007,ap,1,1,Valgt,13785,893,81265,29.89,Det norske Arbeiderparti,14678,2007-09-10,5284,1578.97994021058,2298,14766,12468
kandidat001759,Rune Gerhardsen,2011,ap,2,2,Valgt,8282,368,102707,33.1,Det norske Arbeiderparti,8650,2011-09-12,4956,322.355119316513,508,19722,19214
kandidat001760,Rune Gerhardsen,2015,ap,18,11,Valgt,3183,157,102431,31.97,Arbeiderpartiet,3340,2015-09-14,2510,45.6684058525089,154,22232,22078
kandidat001761,Rune Tveitstul Jensen,2007,mdg,60,43,Ikke valgt,3,0,1687,0.62,Miljøpartiet De Grønne,3,NA,0,0,0,0,0
kandidat001762,Rupinder Kaur Bains,2007,ap,14,14,Valgt,1414,105,81265,29.89,Det norske Arbeiderparti,1519,2007-09-10,7,1.00548590690161,1,7,6
kandidat001763,Ruth Ingeborg Sveinsdotter,2011,krf,36,22,Ikke valgt,61,3,7571,2.44,Kristelig Folkeparti,64,2011-09-12,57,5.20572529229461e-05,0,57,57
kandidat001764,Ruth Jeanette Våler Løkke,2007,krf,26,10,Ikke valgt,57,3,8368,3.08,Kristelig Folkeparti,60,NA,0,0,0,0,0
kandidat001765,Ruth Lillegraven,2007,sp,25,46,Ikke valgt,18,3,2189,0.81,Senterpartiet,21,2007-09-10,139,6.11158228247008,12,142,130
kandidat001766,Ruth Ludvigsen,2007,sfp,10,13,Ikke valgt,7,1,129000,0.05,Samfunnspartiet,8,2007-09-10,6,1.68916626744398,2,12,10
kandidat001767,Ruth Rung,2011,pp,31,25,Ikke valgt,7,0,1045,0.34,Pensjonistpartiet,7,NA,0,0,0,0,0
kandidat001768,Sabina Syed,2015,mdg,21,21,Ikke valgt,353,24,26096,8.14,Miljøpartiet De Grønne,377,2015-09-14,20,0.00447093295762916,0,20,20
kandidat001769,Saeeda Begum,2011,h,7,5,Valgt,1445,89,110776,35.7,Høyre,1534,2011-09-12,4,2.73777429058399,3,4,1
kandidat001770,Safia Abdi,2007,rv,13,14,Ikke valgt,297,45,14131,5.2,Rød Valgallianse,342,2007-09-10,9,0.924434761081791,1,23,22
kandidat001771,Said Aamin,2015,sv,13,20,Ikke valgt,452,55,17445,5.44,Sosialistisk Venstreparti,507,2015-09-14,6,0,0,6,6
kandidat001772,Saida R Begum,2015,h,8,5,Valgt,1377,71,101882,31.8,Høyre,1448,2015-09-14,1,0,0,1,1
kandidat001773,Said Farah,2011,sv,18,30,Ikke valgt,229,32,19477,6.28,Sosialistisk Venstreparti,261,2011-09-12,8,1.42319093192162,2,168,166
kandidat001774,Sajjad Thathaal,2011,rv,7,9,Vara,258,43,11257,3.63,Rødt,301,2011-09-12,1,0.977262483773277,1,7,6
kandidat001775,Sajjad Thathaal,2015,rv,9,10,Vara,318,37,16174,5.05,Rødt,355,2015-09-14,6,1.3920977285823e-05,0,13,13
kandidat001776,Saleh Fahimpor,2011,ap,39,40,Vara,695,16,102707,33.1,Det norske Arbeiderparti,711,2011-09-12,2,0.978367384265891,1,2,1
kandidat001777,Samuel Ahenkorah,2015,ksp,10,12,Ikke valgt,14,2,421,0.13,Partiet De Kristne,16,NA,0,0,0,0,0
kandidat001778,Sanam S. Bokhari,2007,h,20,19,Vara,679,60,68475,25.19,Høyre,739,2007-09-10,1,3.06416896290963e-15,0,3,3
kandidat001779,Sarah Christin Calvert,2011,krf,31,29,Ikke valgt,70,2,7571,2.44,Kristelig Folkeparti,72,2011-09-12,2,0.980445264569787,1,5,4
kandidat001780,Sara Josefine Johansen,2015,nkp,8,7,Ikke valgt,15,2,240,0.07,Norges Kommunistiske Parti,17,NA,0,0,0,0,0
kandidat001781,Sara Marie Blichner,2015,mdg,28,23,Ikke valgt,256,18,26096,8.14,Miljøpartiet De Grønne,274,2015-09-14,11,0.0527414514674128,0,26,26
kandidat001782,Sara V. Wilsgaard,2011,h,56,64,Ikke valgt,277,7,110776,35.7,Høyre,284,2011-09-12,1,0.023006005234057,0,1,1
kandidat001783,Sead Zimeri,2011,mdg,46,51,Ikke valgt,34,4,7653,2.47,Miljøpartiet De Grønne,38,2011-09-12,1,0.11247773365429,1,2,1
kandidat001784,Seher Aydar,2011,rv,25,26,Ikke valgt,124,13,11257,3.63,Rødt,137,2011-09-12,99,1.92321054885206,2,102,100
kandidat001785,Seher Aydar,2015,rv,16,18,Ikke valgt,428,62,16174,5.05,Rødt,490,2015-09-14,1098,3.87278746027438,8,1200,1192
kandidat001786,Seynab Mohamud,2011,v,9,8,Vara,488,62,25351,8.17,Venstre,550,2011-09-12,9,0.000385304005502115,0,9,9
kandidat001787,Shahzad Rana,2011,h,32,45,Vara,619,34,110776,35.7,Høyre,653,2011-09-12,402,4.51178005566518,4,719,715
kandidat001788,Shamima Rahman,2015,rv,42,54,Ikke valgt,114,4,16174,5.05,Rødt,118,2015-09-14,1,1.19304702284095e-06,0,1,1
kandidat001789,Sharam Alghasi,2007,osby,37,38,Ikke valgt,10,5,1466,0.54,Oslo Byaksjon,15,2007-09-10,111,2.20883881575092,6,116,110
kandidat001790,Shilan Abdulgani,2007,sv,18,43,Ikke valgt,443,46,28701,10.56,Sosialistisk Venstreparti,489,NA,0,0,0,0,0
kandidat001791,Shoaib Sultan,2011,mdg,3,3,Vara,480,301,7653,2.47,Miljøpartiet De Grønne,781,2011-09-12,1963,23.9899634718806,47,2231,2184
kandidat001792,Siavash Mobasheri,2015,rv,7,6,Vara,363,52,16174,5.05,Rødt,415,2015-09-14,184,4.03556742563552,5,233,228
kandidat001793,Siavash Sangtarash,2015,sv,5,2,Vara,986,213,17445,5.44,Sosialistisk Venstreparti,1199,2015-09-14,48,13.8585778898178,28,58,30
kandidat001794,Sidsel Kjeldaas Salte,2015,h,58,65,Ikke valgt,308,7,101882,31.8,Høyre,315,2015-09-14,5,0,0,8,8
kandidat001795,Sigmund Hågvar,2007,mdg,57,63,Ikke valgt,4,1,1687,0.62,Miljøpartiet De Grønne,5,2007-09-10,76,0.155304085004909,0,139,139
kandidat001796,Sigmund Hågvar,2011,mdg,38,65,Ikke valgt,37,6,7653,2.47,Miljøpartiet De Grønne,43,2011-09-12,179,4.13400227970731,6,318,312
kandidat001797,Sigmund Vefring,2011,krf,33,25,Ikke valgt,65,5,7571,2.44,Kristelig Folkeparti,70,2011-09-12,7,1.28193644102037,3,8,5
kandidat001798,Sigmund Vefring,2015,krf,39,53,Ikke valgt,45,3,7827,2.44,Kristelig Folkeparti,48,2015-09-14,12,4.78774188264111e-07,0,20,20
kandidat001799,Signe Carlsson,2007,krf,48,28,Ikke valgt,23,4,8368,3.08,Kristelig Folkeparti,27,NA,0,0,0,0,0
kandidat001800,Sigrid Kleiva-Gramstad,2007,ap,39,40,Vara,563,20,81265,29.89,Det norske Arbeiderparti,583,2007-09-10,7,1.80442540757945,2,10,8
kandidat001801,Sigrid Rege Gårdsvoll,2011,krf,38,26,Ikke valgt,60,2,7571,2.44,Kristelig Folkeparti,62,2011-09-12,4,1.03367884915147,1,4,3
kandidat001802,Sigrid Rege Gårdsvoll,2015,krf,7,3,Ikke valgt,224,93,7827,2.44,Kristelig Folkeparti,317,2015-09-14,12,4.0023714044175,6,16,10
kandidat001803,Sigrid Staurset,2007,rv,34,17,Ikke valgt,86,1,14131,5.2,Rød Valgallianse,87,2007-09-10,7,1.92707932172237e-09,0,34,34
kandidat001804,Sigurd Log Røren,2015,ap,55,47,Ikke valgt,577,83,102431,31.97,Arbeiderpartiet,660,2015-09-14,40,0.0846570945508003,0,42,42
kandidat001805,Sikke Næsheim,2007,ap,52,50,Ikke valgt,282,13,81265,29.89,Det norske Arbeiderparti,295,2007-09-10,32,0.462038199516656,0,43,43
kandidat001806,Silje Helene Farner,2007,krf,11,12,Ikke valgt,108,19,8368,3.08,Kristelig Folkeparti,127,2007-09-10,10,1.97883566080507,3,10,7
kandidat001807,Silje Helene Farner-Calvert,2011,krf,8,6,Ikke valgt,217,21,7571,2.44,Kristelig Folkeparti,238,2011-09-12,6,0.859562096257115,3,6,3
kandidat001808,Silje Helene Farner-Calvert,2015,krf,22,19,Ikke valgt,125,6,7827,2.44,Kristelig Folkeparti,131,NA,0,0,0,0,0
kandidat001809,Silje Lutro,2015,h,39,49,Vara,451,49,101882,31.8,Høyre,500,2015-09-14,22,2.86961256582023,5,23,18
kandidat001810,Silje Rygland,2007,ap,45,42,Ikke valgt,460,13,81265,29.89,Det norske Arbeiderparti,473,2007-09-10,4,0.00037484424232881,0,8,8
kandidat001811,Simen Herning,2011,rv,24,22,Ikke valgt,106,35,11257,3.63,Rødt,141,2011-09-12,145,0.352627389638784,1,162,161
kandidat001812,Simen Jakobsen,2007,frp,40,34,Ikke valgt,138,0,38873,14.3,Fremskrittspartiet,138,2007-09-10,5,1.3757429525362,2,7,5
kandidat001813,Sindre Buchanan,2011,mdg,10,9,Ikke valgt,172,27,7653,2.47,Miljøpartiet De Grønne,199,2011-09-12,17,4.14094210031197,8,17,9
kandidat001814,Sindre Hervig,2015,v,50,33,Ikke valgt,90,9,21986,6.86,Venstre,99,2015-09-14,112,2.08819845611254e-05,0,136,136
kandidat001815,Siri Fossheim,2011,ap,31,35,Vara,930,12,102707,33.1,Det norske Arbeiderparti,942,2011-09-12,11,1.43540012773797,2,15,13
kandidat001816,Siri Gåsemyr Staalesen,2007,ap,42,52,Ikke valgt,484,48,81265,29.89,Det norske Arbeiderparti,532,2007-09-10,3,0.916599203984443,1,3,2
kandidat001817,Siri Gåsemyr Staalesen,2011,ap,40,33,Vara,679,16,102707,33.1,Det norske Arbeiderparti,695,2011-09-12,26,2.01290157479558,4,29,25
kandidat001818,Siri Jensen,2007,rv,39,37,Ikke valgt,67,3,14131,5.2,Rød Valgallianse,70,2007-09-10,145,5.49990994257877,3,672,669
kandidat001819,Siri Jensen,2015,rv,43,58,Ikke valgt,112,4,16174,5.05,Rødt,116,2015-09-14,161,0.891510946104392,1,1062,1061
kandidat001820,Siri Mittet,2011,mdg,26,64,Ikke valgt,51,3,7653,2.47,Miljøpartiet De Grønne,54,2011-09-12,3,2.29362588137799e-07,0,128,128
kandidat001821,Siri Mittet,2015,mdg,26,33,Ikke valgt,288,23,26096,8.14,Miljøpartiet De Grønne,311,2015-09-14,80,5.93599961307907,13,208,195
kandidat001822,Sirin Hellvin Stav,2015,mdg,17,13,Ikke valgt,428,45,26096,8.14,Miljøpartiet De Grønne,473,2015-09-14,1,0,0,1,1
kandidat001823,Siri Ulleberg,2015,frp,10,9,Vara,304,26,19311,6.03,Fremskrittspartiet,330,2015-09-14,92,2.68083529685854,7,99,92
kandidat001824,Sissel Hallem,2007,rv,29,16,Ikke valgt,103,9,14131,5.2,Rød Valgallianse,112,2007-09-10,22,0.15542801631112,0,64,64
kandidat001825,Sissel Hallem,2011,rv,47,37,Ikke valgt,57,2,11257,3.63,Rødt,59,2011-09-12,80,0.211377345159887,0,144,144
kandidat001826,Sissel Hallem,2015,rv,5,4,Vara,679,107,16174,5.05,Rødt,786,2015-09-14,38,1.80367273892764,2,182,180
kandidat001827,Sissel Rimehaug Weydahl,2015,krf,42,47,Ikke valgt,45,0,7827,2.44,Kristelig Folkeparti,45,2015-09-14,1,2.56172470349606e-08,0,10,10
kandidat001828,Siv Endresen,2011,mdg,36,22,Ikke valgt,39,4,7653,2.47,Miljøpartiet De Grønne,43,2011-09-12,2,1.16684018109515,2,5,3
kandidat001829,Siv-Lise Bendixen Stærk,2015,v,11,7,Vara,361,42,21986,6.86,Venstre,403,2015-09-14,13,2.02081721373171,3,25,22
kandidat001830,Siyad Mohamed Morsal,2007,sv,15,34,Vara,634,20,28701,10.56,Sosialistisk Venstreparti,654,NA,0,0,0,0,0
kandidat001831,Sjur Beckmann,2007,sp,51,37,Ikke valgt,5,0,2189,0.81,Senterpartiet,5,NA,0,0,0,0,0
kandidat001832,Sjur Beckmann,2011,sp,41,22,Ikke valgt,9,0,1591,0.51,Senterpartiet,9,NA,0,0,0,0,0
kandidat001833,Sjur Jacobsen,2007,kp,36,21,Ikke valgt,0,1,120000,0.04,Kystpartiet,1,2007-09-10,5,0.0163522157029695,0,12,12
kandidat001834,Sjur Ringstad Beckmann,2015,sp,23,18,Ikke valgt,24,2,1926,0.6,Senterpartiet,26,NA,0,0,0,0,0
kandidat001835,Sofie Høgestøl,2015,v,28,35,Ikke valgt,150,22,21986,6.86,Venstre,172,2015-09-14,32,0.329159021041009,0,32,32
kandidat001836,Solfrid Skailand,2011,frp,37,18,Ikke valgt,95,4,21852,7.04,Fremskrittspartiet,99,2011-09-12,13,0.0376962516190649,0,14,14
kandidat001837,Solfrid Syversen,2007,krf,39,56,Ikke valgt,30,1,8368,3.08,Kristelig Folkeparti,31,NA,0,0,0,0,0
kandidat001838,Solfrid Tandberg Øhrn,2007,krf,64,64,Ikke valgt,18,1,8368,3.08,Kristelig Folkeparti,19,NA,0,0,0,0,0
kandidat001839,Solvår Meløysund,2007,kp,24,28,Ikke valgt,0,2,120000,0.04,Kystpartiet,2,NA,0,0,0,0,0
kandidat001840,Solveig Arnesen,2015,mdg,35,31,Ikke valgt,190,11,26096,8.14,Miljøpartiet De Grønne,201,2015-09-14,110,3.07032318792497,8,162,154
kandidat001841,Solveig Tesdal,2011,sv,28,29,Ikke valgt,186,20,19477,6.28,Sosialistisk Venstreparti,206,2011-09-12,37,1.46587270031635,2,575,573
kandidat001842,Sølve Seim,2007,dem,37,35,Ikke valgt,0,1,306000,0.11,Demokratene,1,NA,0,0,0,0,0
kandidat001843,Sølvi Slørdahl,2011,rv,60,54,Ikke valgt,32,3,11257,3.63,Rødt,35,NA,0,0,0,0,0
kandidat001844,Sriskanthan Kanagavale,2007,v,27,43,Ikke valgt,208,20,23703,8.72,Venstre,228,NA,0,0,0,0,0
kandidat001845,Ståle Hagen,2007,h,37,31,Ikke valgt,393,10,68475,25.19,Høyre,403,2007-09-10,48,2.66873279965245,4,141,137
kandidat001846,Ståle Hagen,2011,h,42,30,Vara,459,29,110776,35.7,Høyre,488,2011-09-12,239,10.0207948926978,14,380,366
kandidat001847,Ståle Hagen,2015,h,26,29,Vara,724,39,101882,31.8,Høyre,763,2015-09-14,110,2.82519120831224,9,490,481
kandidat001848,Ståle Slettebø,2007,mdg,25,21,Ikke valgt,17,4,1687,0.62,Miljøpartiet De Grønne,21,2007-09-10,4,1.73054097267399,3,397,394
kandidat001849,Ståle Sørensen,2007,v,9,15,Vara,387,182,23703,8.72,Venstre,569,2007-09-10,144,16.7910458723051,33,200,167
kandidat001850,Stefan Heggelund,2011,h,19,31,Valgt,923,36,110776,35.7,Høyre,959,2011-09-12,72,2.55031379897052,4,155,151
kandidat001851,Stein Aker,2011,dem,3,7,Ikke valgt,10,4,214000,0.07,Demokratene i Norge,14,2011-09-12,14,0.0303240904080129,0,43,43
kandidat001852,Steinar Åge Brenden,2011,nkp,11,8,Ikke valgt,9,3,210000,0.07,Norges Kommunistiske Parti,12,2011-09-12,7,8.67966421051875e-10,0,18,18
kandidat001853,Steinar Åge Brenden,2015,nkp,7,9,Ikke valgt,15,4,240,0.07,Norges Kommunistiske Parti,19,2015-09-14,7,7.06030396436168e-05,0,25,25
kandidat001854,Steinar Brenden,2007,nkp,19,14,Ikke valgt,5,0,203000,0.07,Norges Kommunistiske Parti,5,2007-09-10,37,2.47063287205017,12,61,49
kandidat001855,Stein Asthøy,2007,rv,38,30,Ikke valgt,67,11,14131,5.2,Rød Valgallianse,78,2007-09-10,17,0.19879159232166,1,80,79
kandidat001856,Stein Georg Kvernberg,2007,mdg,26,25,Ikke valgt,17,3,1687,0.62,Miljøpartiet De Grønne,20,2007-09-10,2,0.0825676363661644,0,4,4
kandidat001857,Sten I. Jørgensen,2007,osby,28,35,Ikke valgt,17,7,1466,0.54,Oslo Byaksjon,24,NA,0,0,0,0,0
kandidat001858,Stephane Pfister,2007,kp,25,30,Ikke valgt,1,1,120000,0.04,Kystpartiet,2,NA,0,0,0,0,0
kandidat001859,Stephan Granhaug,2007,osby,10,8,Ikke valgt,25,14,1466,0.54,Oslo Byaksjon,39,2007-09-10,5,0.0085338147852691,0,8,8
kandidat001860,Stephen Anene,2007,ap,34,49,Vara,672,10,81265,29.89,Det norske Arbeiderparti,682,2007-09-10,6,0.912479993777571,1,9,8
kandidat001861,Stian Andreassen,2007,dem,45,20,Ikke valgt,0,0,306000,0.11,Demokratene,0,2007-09-10,67,7.88341088430439,19,113,94
kandidat001862,Stian Antonsen,2007,sv,49,46,Ikke valgt,117,5,28701,10.56,Sosialistisk Venstreparti,122,2007-09-10,96,10.7223387408278,20,119,99
kandidat001863,Stian Antonsen,2011,sv,26,22,Ikke valgt,177,39,19477,6.28,Sosialistisk Venstreparti,216,2011-09-12,115,1.96459879032334,4,234,230
kandidat001864,Stian Berger Røsland,2011,h,2,2,Valgt,6388,331,110776,35.7,Høyre,6719,2011-09-12,5160,603.909531679441,1105,5197,4092
kandidat001865,Stian Berger Røsland,2015,h,2,2,Valgt,8559,410,101882,31.8,Høyre,8969,2015-09-14,12640,588.485908205016,1032,17837,16805
kandidat001866,Stig Berntsen,2015,rv,34,20,Ikke valgt,147,12,16174,5.05,Rødt,159,2015-09-14,254,23.8562884410483,33,384,351
kandidat001867,Stig Einar Rygh-Johansen,2015,mdg,56,16,Ikke valgt,107,8,26096,8.14,Miljøpartiet De Grønne,115,NA,0,0,0,0,0
kandidat001868,Stig Granum,2007,dem,36,32,Ikke valgt,0,1,306000,0.11,Demokratene,1,NA,0,0,0,0,0
kandidat001869,Stig Tollefsen,2015,v,64,56,Ikke valgt,43,5,21986,6.86,Venstre,48,2015-09-14,5,0.0310238227413517,0,57,57
kandidat001870,Stina Bergsten,2015,fi,22,26,Ikke valgt,28,4,1388,0.43,Feministisk Initiativ,32,2015-09-14,32,0.743295116314286,3,32,29
kandidat001871,Stina Karlsen,2007,nkp,12,13,Ikke valgt,4,5,203000,0.07,Norges Kommunistiske Parti,9,2007-09-10,3,0.0340134247237325,0,12,12
kandidat001872,Stine Fink Karlsen,2007,mdg,52,38,Ikke valgt,6,0,1687,0.62,Miljøpartiet De Grønne,6,2007-09-10,1,2.0719921959656e-06,0,1,1
kandidat001873,Stine Møller Nilsen,2007,v,12,9,Vara,436,22,23703,8.72,Venstre,458,2007-09-10,11,3.74592551436005,6,11,5
kandidat001874,Sturla Espolin Johnson,2007,krf,43,41,Ikke valgt,26,3,8368,3.08,Kristelig Folkeparti,29,2007-09-10,3,7.85197611505002e-13,0,6,6
kandidat001875,Sturla Henriksbø,2011,krf,17,17,Ikke valgt,119,21,7571,2.44,Kristelig Folkeparti,140,2011-09-12,310,16.0896722853459,101,354,253
kandidat001876,Sunniva Holmås Eidsvoll,2015,sv,3,3,Valgt,1770,440,17445,5.44,Sosialistisk Venstreparti,2210,2015-09-14,259,17.9718958549463,28,259,231
kandidat001877,Sunniva Laake,2015,ksp,6,3,Ikke valgt,20,4,421,0.13,Partiet De Kristne,24,NA,0,0,0,0,0
kandidat001878,Sunniva Pettersen Eidsvoll,2011,sv,29,43,Ikke valgt,190,14,19477,6.28,Sosialistisk Venstreparti,204,2011-09-12,1,3.01700867922603e-09,0,20,20
kandidat001879,Sunniva Rebekka Skjeggestad,2011,v,36,59,Ikke valgt,125,7,25351,8.17,Venstre,132,NA,0,0,0,0,0
kandidat001880,Suresh Chandra Shukla,2007,sv,24,38,Ikke valgt,292,44,28701,10.56,Sosialistisk Venstreparti,336,2007-09-10,18,0.00641272857924008,0,55,55
kandidat001881,Susana Mercedes Kværndal,2015,sv,24,23,Ikke valgt,255,7,17445,5.44,Sosialistisk Venstreparti,262,2015-09-14,3,0.505442919669345,1,5,4
kandidat001882,Susann Jørgensen,2015,ap,32,14,Vara,1390,29,102431,31.97,Arbeiderpartiet,1419,2015-09-14,23,0.00143757077648692,0,34,34
kandidat001883,Susann Strandberg Jørgensen,2011,ap,54,45,Ikke valgt,424,11,102707,33.1,Det norske Arbeiderparti,435,2011-09-12,1,0.616929823373548,1,1,0
kandidat001884,Svanhild Helle Enstad,2007,krf,32,30,Ikke valgt,44,1,8368,3.08,Kristelig Folkeparti,45,2007-09-10,1,0.525187467067436,1,1,0
kandidat001885,Svein Arne Nordølum,2007,dem,9,10,Ikke valgt,9,0,306000,0.11,Demokratene,9,2007-09-10,1,4.2063959363214e-13,0,47,47
kandidat001886,Svein Erik Aldal,2007,frp,32,31,Ikke valgt,164,1,38873,14.3,Fremskrittspartiet,165,2007-09-10,11,1.45724524784212,2,11,9
kandidat001887,Svein Harald Smaadal,2011,pp,15,18,Ikke valgt,12,3,1045,0.34,Pensjonistpartiet,15,NA,0,0,0,0,0
kandidat001888,Svein Lanser,2011,mdg,31,17,Ikke valgt,42,6,7653,2.47,Miljøpartiet De Grønne,48,2011-09-12,23,2.94536627887574,6,35,29
kandidat001889,Svein Sundsbø,2011,sp,22,49,Ikke valgt,11,5,1591,0.51,Senterpartiet,16,2011-09-12,334,3.20039367118284,5,1239,1234
kandidat001890,Svein Sundsbø,2015,sp,11,23,Ikke valgt,42,7,1926,0.6,Senterpartiet,49,2015-09-14,295,6.06135358034436,13,1534,1521
kandidat001891,Sveinung Legard,2007,da,1,1,Ikke valgt,29,32,191000,0.07,Demokratisk Alternativ for Oslo,61,2007-09-10,9,1.64169103639662,2,15,13
kandidat001892,Sven Erling Thorsen,2007,v,57,58,Ikke valgt,97,11,23703,8.72,Venstre,108,2007-09-10,1,0.0141930907455777,0,1,1
kandidat001893,Svenn Erik Kristiansen,2007,frp,1,1,Valgt,4936,378,38873,14.3,Fremskrittspartiet,5314,2007-09-10,58,5.23365998726685,7,72,65
kandidat001894,Sven Sæther,2011,nkp,15,14,Ikke valgt,7,1,210000,0.07,Norges Kommunistiske Parti,8,2011-09-12,13,0.0328440810448443,0,53,53
kandidat001895,Sverre Kirkeby,2015,pp,14,9,Ikke valgt,17,2,1169,0.36,Pensjonistpartiet,19,NA,0,0,0,0,0
kandidat001896,Sverre Molandsveen,2007,v,25,17,Ikke valgt,203,27,23703,8.72,Venstre,230,2007-09-10,204,0.956603113659004,1,236,235
kandidat001897,Sverre Molandsveen,2011,v,40,51,Ikke valgt,105,13,25351,8.17,Venstre,118,2011-09-12,2,0.955041962190718,1,238,237
kandidat001898,Sverre Vatnar,2007,krf,53,57,Ikke valgt,25,0,8368,3.08,Kristelig Folkeparti,25,2007-09-10,2,1.73150984401445,2,2,0
kandidat001899,Sverre Vatnar,2011,krf,26,27,Ikke valgt,90,5,7571,2.44,Kristelig Folkeparti,95,2011-09-12,22,0.617351108580333,1,24,23
kandidat001900,Sverre Vatnar,2015,krf,28,20,Ikke valgt,95,7,7827,2.44,Kristelig Folkeparti,102,2015-09-14,90,0.00627293257990192,0,114,114
kandidat001901,Svetlana Fjæren,2007,h,35,24,Vara,401,10,68475,25.19,Høyre,411,2007-09-10,3,1.3713999620172,2,3,1
kandidat001902,Sylvi Listhaug,2007,frp,3,3,Valgt,1697,157,38873,14.3,Fremskrittspartiet,1854,2007-09-10,1817,183.756585171517,458,1841,1383
kandidat001903,Synne Øverland Knudsen,2015,mdg,40,63,Ikke valgt,172,7,26096,8.14,Miljøpartiet De Grønne,179,2015-09-14,342,17.7397200959372,27,524,497
kandidat001904,Syver Glordencio Zachariassen,2015,sp,9,4,Ikke valgt,48,7,1926,0.6,Senterpartiet,55,NA,0,0,0,0,0
kandidat001905,Talat Mehmood Butt,2015,h,35,58,Vara,423,153,101882,31.8,Høyre,576,2015-09-14,5,0.246464982463248,2,7,5
kandidat001906,Tale Marte Dæhlen,2015,rv,6,9,Vara,432,47,16174,5.05,Rødt,479,2015-09-14,16,6.88751043693206e-08,0,38,38
kandidat001907,Tanja Lund,2007,sv,48,56,Ikke valgt,124,5,28701,10.56,Sosialistisk Venstreparti,129,2007-09-10,3,0.114290339192973,1,4,3
kandidat001908,Tanja Nordang,2007,nkp,4,2,Ikke valgt,12,11,203000,0.07,Norges Kommunistiske Parti,23,NA,0,0,0,0,0
kandidat001909,Terje Bjøro,2007,v,10,26,Vara,398,133,23703,8.72,Venstre,531,2007-09-10,276,7.65624940536878,19,676,657
kandidat001910,Terje Bjøro,2011,v,8,27,Vara,357,229,25351,8.17,Venstre,586,2011-09-12,269,9.53817593806506,21,945,924
kandidat001911,Terje Granli,2007,dem,39,46,Ikke valgt,1,0,306000,0.11,Demokratene,1,2007-09-10,49,4.75290744109261,8,93,85
kandidat001912,Terje Kortner,2007,da,6,7,Ikke valgt,7,8,191000,0.07,Demokratisk Alternativ for Oslo,15,NA,0,0,0,0,0
kandidat001913,Terje Larsen,2007,sv,57,54,Ikke valgt,84,3,28701,10.56,Sosialistisk Venstreparti,87,2007-09-10,1088,41.424807353943,105,1758,1653
kandidat001914,Terje Lauritzen,2007,frp,8,6,Valgt,523,17,38873,14.3,Fremskrittspartiet,540,2007-09-10,40,3.66630569459782,5,56,51
kandidat001915,Terje Lauritzen,2011,frp,19,19,Ikke valgt,133,21,21852,7.04,Fremskrittspartiet,154,2011-09-12,176,6.64464401422449,12,232,220
kandidat001916,Terje Lorentzen,2015,ksp,14,14,Ikke valgt,9,1,421,0.13,Partiet De Kristne,10,2015-09-14,16,0.00257596953791786,0,68,68
kandidat001917,Terje Mikalsen,2007,pp,23,21,Ikke valgt,6,3,1414,0.52,Pensjonistpartiet,9,2007-09-10,284,2.30648037758127,7,1790,1783
kandidat001918,Terje Mikalsen,2011,pp,3,4,Ikke valgt,29,6,1045,0.34,Pensjonistpartiet,35,2011-09-12,158,3.48630436147522,3,1948,1945
kandidat001919,Terje Mikalsen,2015,pp,3,3,Ikke valgt,32,11,1169,0.36,Pensjonistpartiet,43,2015-09-14,192,14.6326679797078,38,2140,2102
kandidat001920,Terje Skog,2007,rv,19,15,Ikke valgt,169,24,14131,5.2,Rød Valgallianse,193,2007-09-10,668,14.1515965928565,16,771,755
kandidat001921,Terje Sven Skog,2011,rv,29,18,Ikke valgt,103,7,11257,3.63,Rødt,110,NA,0,0,0,0,0
kandidat001922,Thea Kristine Schjerven,2015,h,37,37,Vara,514,15,101882,31.8,Høyre,529,2015-09-14,20,0.23274881007187,1,26,25
kandidat001923,Thea K. Schjerven,2011,h,54,48,Ikke valgt,296,26,110776,35.7,Høyre,322,NA,0,0,0,0,0
kandidat001924,Theo Koritzinsky,2015,sv,19,55,Ikke valgt,270,55,17445,5.44,Sosialistisk Venstreparti,325,2015-09-14,495,2.52547063488266,4,2993,2989
kandidat001925,Therese Rosenlund,2011,mdg,58,48,Ikke valgt,24,0,7653,2.47,Miljøpartiet De Grønne,24,2011-09-12,1,0.000334123457517233,0,5,5
kandidat001926,Therese Thorvaldsen,2007,osby,55,36,Ikke valgt,4,3,1466,0.54,Oslo Byaksjon,7,2007-09-10,1,5.58506265532297e-07,0,3,3
kandidat001927,Therese Vangstad,2015,v,62,58,Ikke valgt,61,2,21986,6.86,Venstre,63,2015-09-14,60,0.000858170308851293,0,121,121
kandidat001928,Thomas Gramstad,2015,pirat,3,2,Ikke valgt,44,45,805,0.25,Piratpartiet,89,2015-09-14,37,0.255544422449601,2,278,276
kandidat001929,Thomas H. Overdale,2011,frp,51,45,Ikke valgt,67,0,21852,7.04,Fremskrittspartiet,67,2011-09-12,1,0.00855704806947802,0,2,2
kandidat001930,Thomas Hylland Eriksen,2007,osby,12,23,Ikke valgt,113,104,1466,0.54,Oslo Byaksjon,217,2007-09-10,2289,32.8173832616922,83,3494,3411
kandidat001931,Thomas Hylland Eriksen,2011,mdg,8,59,Ikke valgt,209,44,7653,2.47,Miljøpartiet De Grønne,253,2011-09-12,2053,113.262215204796,236,5547,5311
kandidat001932,Thomas Hylland Eriksen,2015,mdg,13,60,Vara,852,93,26096,8.14,Miljøpartiet De Grønne,945,2015-09-14,2338,79.9236456296162,176,7885,7709
kandidat001933,Thomas Jahreie,2007,h,52,37,Ikke valgt,220,3,68475,25.19,Høyre,223,2007-09-10,2,0.0139506543143792,0,11,11
kandidat001934,Thomas M. Johanson,2007,dlf,5,5,Ikke valgt,5,1,127000,0.05,Det Liberale Folkepartiet,6,2007-09-10,3,1.28257897022099e-06,0,4,4
kandidat001935,Thomas M. Johanson,2011,dlf,3,2,Ikke valgt,17,7,247000,0.08,Det Liberale Folkepartiet,24,2011-09-12,8,0.0651732964128735,0,12,12
kandidat001936,Thomas Tallaksen,2011,sv,31,21,Ikke valgt,173,11,19477,6.28,Sosialistisk Venstreparti,184,2011-09-12,104,1.44944897364889,4,269,265
kandidat001937,Thomas Wendelborg,2015,v,63,62,Ikke valgt,52,6,21986,6.86,Venstre,58,2015-09-14,16,0.00584461353654776,0,25,25
kandidat001938,Thor Arvid Dyrerud,2007,osby,63,54,Ikke valgt,0,1,1466,0.54,Oslo Byaksjon,1,2007-09-10,11,0.0976979025394036,0,20,20
kandidat001939,Thordis Widvey Haugen,2015,h,57,36,Ikke valgt,316,6,101882,31.8,Høyre,322,2015-09-14,9,2.48048284514071,3,9,6
kandidat001940,Thor Egil Braadland,2015,sv,51,36,Ikke valgt,76,7,17445,5.44,Sosialistisk Venstreparti,83,2015-09-14,187,1.86471832832417,4,313,309
kandidat001941,Thore Lie,2015,ksp,7,8,Ikke valgt,19,2,421,0.13,Partiet De Kristne,21,2015-09-14,53,0.336637831738324,1,201,200
kandidat001942,Thore Slåttedalen,2007,krf,62,55,Ikke valgt,21,1,8368,3.08,Kristelig Folkeparti,22,2007-09-10,2,1.31989634965932,2,2,0
kandidat001943,Thorleif Holm Glad,2007,krf,49,35,Ikke valgt,25,2,8368,3.08,Kristelig Folkeparti,27,2007-09-10,3,0.0502875569998961,0,35,35
kandidat001944,Thorvald Stoltenberg,2015,ap,14,65,Valgt,3624,233,102431,31.97,Arbeiderpartiet,3857,2015-09-14,4994,140.556967179604,307,26202,25895
kandidat001945,Thuong N Le,2015,krf,49,38,Ikke valgt,26,3,7827,2.44,Kristelig Folkeparti,29,NA,0,0,0,0,0
kandidat001946,Tian Riseng,2007,dem,12,17,Ikke valgt,3,3,306000,0.11,Demokratene,6,NA,0,0,0,0,0
kandidat001947,Tiina Johanna Ruohonen,2011,mdg,11,8,Ikke valgt,170,12,7653,2.47,Miljøpartiet De Grønne,182,NA,0,0,0,0,0
kandidat001948,Tina Alvær,2015,h,53,57,Ikke valgt,305,33,101882,31.8,Høyre,338,2015-09-14,9,0.444371513938691,3,10,7
kandidat001949,Tina Shagufta Kornmo,2011,v,44,46,Ikke valgt,87,9,25351,8.17,Venstre,96,2011-09-12,506,7.58335764368858,17,508,491
kandidat001950,Tina Shagufta Kornmo,2015,v,32,42,Ikke valgt,144,20,21986,6.86,Venstre,164,2015-09-14,414,5.96380351146775,15,922,907
kandidat001951,Tina Skotnes,2015,fi,4,5,Ikke valgt,75,86,1388,0.43,Feministisk Initiativ,161,2015-09-14,21,1.70763162138422,2,23,21
kandidat001952,Tine Eide,2015,fi,20,19,Ikke valgt,24,8,1388,0.43,Feministisk Initiativ,32,2015-09-14,208,1.17738049892085,4,583,579
kandidat001953,Tobias Brox,2015,pirat,11,10,Ikke valgt,28,5,805,0.25,Piratpartiet,33,2015-09-14,21,0.112178636280697,0,30,30
kandidat001954,Tomas Andreassen,2007,sfp,9,14,Ikke valgt,9,0,129000,0.05,Samfunnspartiet,9,NA,0,0,0,0,0
kandidat001955,Tom Erlend Skaug,2007,h,50,51,Ikke valgt,239,2,68475,25.19,Høyre,241,2007-09-10,17,1.98853936794084,2,31,29
kandidat001956,Tom H. Larsen,2011,frp,27,25,Ikke valgt,119,3,21852,7.04,Fremskrittspartiet,122,2011-09-12,29,1.00146542317851,1,35,34
kandidat001957,Tom Kandal,2007,kp,37,24,Ikke valgt,1,0,120000,0.04,Kystpartiet,1,NA,0,0,0,0,0
kandidat001958,Tom Kandal,2011,kp,11,13,Ikke valgt,4,0,126000,0.04,Kystpartiet,4,NA,0,0,0,0,0
kandidat001959,Tom Kandal,2015,kp,2,2,Ikke valgt,13,4,124,0.04,Kystpartiet,17,2015-09-14,1,0.871098691745798,1,1,0
kandidat001960,Tommy Skjervold,2011,frp,13,26,Ikke valgt,190,42,21852,7.04,Fremskrittspartiet,232,2011-09-12,221,9.41389465639033,26,244,218
kandidat001961,Tommy Skjervold,2015,frp,3,3,Valgt,928,104,19311,6.03,Fremskrittspartiet,1032,2015-09-14,181,7.95322307091573,12,425,413
kandidat001962,"Tommy ""Tommy Tee"" Flåten",2015,rv,13,62,Ikke valgt,614,49,16174,5.05,Rødt,663,NA,0,0,0,0,0
kandidat001963,Tom-Reiel Heggedal,2011,v,41,37,Ikke valgt,107,7,25351,8.17,Venstre,114,2011-09-12,3,3.7795986309142e-07,0,6,6
kandidat001964,Tom Rellsve,2011,sv,55,52,Ikke valgt,68,1,19477,6.28,Sosialistisk Venstreparti,69,2011-09-12,21,0.026940042124321,0,70,70
kandidat001965,Tom Rune Larsen,2011,dem,16,11,Ikke valgt,5,0,214000,0.07,Demokratene i Norge,5,2011-09-12,11,0.156584749323999,1,30,29
kandidat001966,Tom Thorkildsen,2007,dem,40,50,Ikke valgt,0,1,306000,0.11,Demokratene,1,2007-09-10,44,0.000684854667419347,0,62,62
kandidat001967,Tone Ask Sørensen,2007,mdg,5,6,Ikke valgt,77,36,1687,0.62,Miljøpartiet De Grønne,113,NA,0,0,0,0,0
kandidat001968,Tone Birkelund,2007,ap,30,26,Vara,779,11,81265,29.89,Det norske Arbeiderparti,790,2007-09-10,9,1.00001915893418,1,10,9
kandidat001969,Tone Bjåland,2011,sv,48,51,Ikke valgt,85,4,19477,6.28,Sosialistisk Venstreparti,89,2011-09-12,24,2.6508655995223,6,27,21
kandidat001970,Tone Bjørnhaug,2007,osby,58,53,Ikke valgt,3,3,1466,0.54,Oslo Byaksjon,6,2007-09-10,4,0.107427350623958,1,5,4
kandidat001971,Tone E. Ims Larssen,2011,frp,30,28,Ikke valgt,106,11,21852,7.04,Fremskrittspartiet,117,2011-09-12,8,0.397409872954317,2,8,6
kandidat001972,Tone Hansen,2007,osby,34,28,Ikke valgt,10,8,1466,0.54,Oslo Byaksjon,18,2007-09-10,404,28.358027484257,64,580,516
kandidat001973,Tone Ims Larssen,2015,frp,8,4,Vara,348,35,19311,6.03,Fremskrittspartiet,383,2015-09-14,27,0.816878360508597,2,34,32
kandidat001974,Tone Opdahl,2007,v,21,14,Ikke valgt,257,24,23703,8.72,Venstre,281,2007-09-10,5,0.0019191798561695,0,14,14
kandidat001975,Tone Ringen,2007,v,54,53,Ikke valgt,110,4,23703,8.72,Venstre,114,2007-09-10,80,1.99840797851361,5,481,476
kandidat001976,Tone Ringen,2011,v,22,15,Ikke valgt,191,31,25351,8.17,Venstre,222,2011-09-12,227,1.38982173515215,2,708,706
kandidat001977,Tone Tellevik Dahl,2007,ap,7,8,Valgt,1985,72,81265,29.89,Det norske Arbeiderparti,2057,2007-09-10,117,6.87147189212814,14,214,200
kandidat001978,Tone Tellevik Dahl,2011,ap,7,5,Valgt,2390,101,102707,33.1,Det norske Arbeiderparti,2491,2011-09-12,908,35.8072094297445,57,1122,1065
kandidat001979,Tone Tellevik Dahl,2015,ap,2,2,Valgt,5614,374,102431,31.97,Arbeiderpartiet,5988,2015-09-14,1791,146.571432568604,251,2913,2662
kandidat001980,Tonje Brubakken,2011,dem,8,10,Ikke valgt,5,3,214000,0.07,Demokratene i Norge,8,NA,0,0,0,0,0
kandidat001981,Tonje Eide,2015,fi,27,20,Ikke valgt,17,5,1388,0.43,Feministisk Initiativ,22,2015-09-14,85,6.91451606276878,16,211,195
kandidat001982,Tonje Martinsen,2015,fi,18,16,Ikke valgt,28,9,1388,0.43,Feministisk Initiativ,37,2015-09-14,25,0.392261568070917,2,76,74
kandidat001983,Tony Christian Tiller,2015,h,48,45,Ikke valgt,390,39,101882,31.8,Høyre,429,2015-09-14,10,1.66856812188263,3,10,7
kandidat001984,Torbjørn Furulund,2007,h,34,26,Vara,402,21,68475,25.19,Høyre,423,2007-09-10,28,1.34094980231287,2,45,43
kandidat001985,Torbjørn Furulund,2011,h,49,27,Ikke valgt,358,31,110776,35.7,Høyre,389,2011-09-12,32,1.42945968898449,2,77,75
kandidat001986,Torbjørn Matre,2007,krf,19,47,Ikke valgt,74,4,8368,3.08,Kristelig Folkeparti,78,2007-09-10,13,0.556080244937897,2,16,14
kandidat001987,Torbjørn Sølsnæs,2011,h,58,57,Ikke valgt,250,12,110776,35.7,Høyre,262,2011-09-12,37,3.77682291779055,6,40,34
kandidat001988,Tor Brattgjerd,2007,krf,40,23,Ikke valgt,29,1,8368,3.08,Kristelig Folkeparti,30,NA,0,0,0,0,0
kandidat001989,Tore Aabø,2007,dlf,4,2,Ikke valgt,5,2,127000,0.05,Det Liberale Folkepartiet,7,2007-09-10,1,0.0778477720195426,0,5,5
kandidat001990,Tore Aabø,2011,dlf,6,9,Ikke valgt,8,0,247000,0.08,Det Liberale Folkepartiet,8,2011-09-12,4,0.289716404592076,2,9,7
kandidat001991,Tore Andreas Larsen,2011,frp,47,39,Ikke valgt,70,1,21852,7.04,Fremskrittspartiet,71,2011-09-12,45,0.00889117152791646,0,251,251
kandidat001992,Tore Hermundsson Vigerust,2007,h,64,60,Ikke valgt,165,2,68475,25.19,Høyre,167,NA,0,0,0,0,0
kandidat001993,Tore Holte Follestad,2007,h,40,25,Ikke valgt,330,30,68475,25.19,Høyre,360,2007-09-10,43,0.00821356715239575,0,168,168
kandidat001994,Tore-Jan Øvsthun,2007,frp,22,13,Ikke valgt,222,7,38873,14.3,Fremskrittspartiet,229,2007-09-10,31,0.268430251550429,1,67,66
kandidat001995,Tore-Jan Øvsthun,2011,frp,45,41,Ikke valgt,74,2,21852,7.04,Fremskrittspartiet,76,2011-09-12,13,1.06367054097734,1,80,79
kandidat001996,Tore Nielsen,2011,dem,14,23,Ikke valgt,5,1,214000,0.07,Demokratene i Norge,6,2011-09-12,419,6.64413461907572,11,515,504
kandidat001997,Tor Erling Staff,2007,sfp,1,1,Ikke valgt,33,151,129000,0.05,Samfunnspartiet,184,2007-09-10,5045,417.482527660254,1055,14385,13330
kandidat001998,Tore Wilhelmsen,2015,ksp,3,9,Ikke valgt,30,2,421,0.13,Partiet De Kristne,32,2015-09-14,137,4.44362118333011,10,254,244
kandidat001999,Torgeir Ingebrigtsen,2011,ksp,7,6,Ikke valgt,9,3,235000,0.08,Kristent Samlingsparti,12,2011-09-12,15,0.857247670517548,1,24,23
kandidat002000,Torgeir Salih Holgersen,2007,sv,52,44,Ikke valgt,108,10,28701,10.56,Sosialistisk Venstreparti,118,NA,0,0,0,0,0
kandidat002001,Torgrim Eggen,2011,mdg,19,61,Ikke valgt,73,9,7653,2.47,Miljøpartiet De Grønne,82,2011-09-12,1258,22.2250414996615,50,2994,2944
kandidat002002,Torhild Aronsen,2011,dem,15,4,Ikke valgt,2,3,214000,0.07,Demokratene i Norge,5,2011-09-12,3,0.181338883934134,0,6,6
kandidat002003,Torhild Helliesen,2007,kp,4,2,Ikke valgt,7,2,120000,0.04,Kystpartiet,9,2007-09-10,10,0.952911514669936,1,11,10
kandidat002004,Torhild Helliesen,2011,kp,1,1,Ikke valgt,11,12,126000,0.04,Kystpartiet,23,2011-09-12,68,7.94047574900023e-08,0,79,79
kandidat002005,Torhild Helliesen,2015,kp,1,1,Ikke valgt,16,7,124,0.04,Kystpartiet,23,2015-09-14,11,2.3663273675267,4,90,86
kandidat002006,Torhild Holen Fikseaunet,2011,krf,48,32,Ikke valgt,34,2,7571,2.44,Kristelig Folkeparti,36,2011-09-12,3,1.7233139953322,3,3,0
kandidat002007,Tori Hoven,2007,v,59,41,Ikke valgt,88,4,23703,8.72,Venstre,92,NA,0,0,0,0,0
kandidat002008,Toril Berge,2007,v,4,2,Valgt,1450,240,23703,8.72,Venstre,1690,2007-09-10,127,7.97493166828846,14,732,718
kandidat002009,Toril Berge,2011,v,4,2,Valgt,1224,197,25351,8.17,Venstre,1421,2011-09-12,204,18.786993673699,26,936,910
kandidat002010,Toril Berge Flatabø,2015,v,4,3,Valgt,779,105,21986,6.86,Venstre,884,2015-09-14,38,2.36619501056777,3,38,35
kandidat002011,Toril Charlotte Reynolds,2015,frp,9,6,Vara,308,31,19311,6.03,Fremskrittspartiet,339,2015-09-14,21,0.00201990641178244,0,21,21
kandidat002012,Toril Fiskerstrand,2007,h,12,23,Valgt,1447,507,68475,25.19,Høyre,1954,2007-09-10,477,370.497689038654,406,510,104
kandidat002013,Torill Anita Gran Larsen,2007,pp,5,8,Ikke valgt,24,1,1414,0.52,Pensjonistpartiet,25,NA,0,0,0,0,0
kandidat002014,Torill Anita Gran Larsen,2011,pp,6,5,Ikke valgt,18,4,1045,0.34,Pensjonistpartiet,22,NA,0,0,0,0,0
kandidat002015,Torill Anita Gran Larsen,2015,pp,4,6,Ikke valgt,28,4,1169,0.36,Pensjonistpartiet,32,NA,0,0,0,0,0
kandidat002016,Torill Frøise,2007,sp,14,22,Ikke valgt,22,12,2189,0.81,Senterpartiet,34,2007-09-10,7,0.00498711095169787,0,7,7
kandidat002017,Torkild Strandvik,2011,v,55,60,Ikke valgt,64,2,25351,8.17,Venstre,66,2011-09-12,27,4.22838446211944,8,55,47
kandidat002018,Torkil Vederhus,2015,mdg,18,20,Ikke valgt,341,123,26096,8.14,Miljøpartiet De Grønne,464,2015-09-14,333,5.6772620834756,7,368,361
kandidat002019,Tor Kristian Birkeland,2011,mdg,39,21,Ikke valgt,31,9,7653,2.47,Miljøpartiet De Grønne,40,2011-09-12,8,1.61074496330405,2,12,10
kandidat002020,Tor Kristian Lånke,2007,krf,56,45,Ikke valgt,23,1,8368,3.08,Kristelig Folkeparti,24,2007-09-10,21,1.08203810001553e-07,0,23,23
kandidat002021,Torleif Johnsen,2007,mdg,34,60,Ikke valgt,9,4,1687,0.62,Miljøpartiet De Grønne,13,2007-09-10,102,4.57630068853755,9,191,182
kandidat002022,Tor Løken,2011,frp,52,49,Ikke valgt,63,1,21852,7.04,Fremskrittspartiet,64,2011-09-12,32,0.128256547502028,0,121,121
kandidat002023,Tor Magne Søreng,2007,kp,39,38,Ikke valgt,1,0,120000,0.04,Kystpartiet,1,2007-09-10,5,0.000842796333431448,0,10,10
kandidat002024,Tormod Vaaland Burkey,2011,mdg,49,27,Ikke valgt,25,6,7653,2.47,Miljøpartiet De Grønne,31,2011-09-12,24,7.43531296246963e-10,0,44,44
kandidat002025,Tor Øistein Andresen,2011,v,37,21,Ikke valgt,124,7,25351,8.17,Venstre,131,NA,0,0,0,0,0
kandidat002026,Torstein Bae,2015,sv,34,40,Ikke valgt,163,31,17445,5.44,Sosialistisk Venstreparti,194,2015-09-14,1259,25.9891011109935,60,2343,2283
kandidat002027,Torstein Hallaråker,2015,frp,33,31,Ikke valgt,85,3,19311,6.03,Fremskrittspartiet,88,2015-09-14,2,8.64607007075974e-07,0,16,16
kandidat002028,Torunn Kanutte Husvik,2015,ap,57,50,Ikke valgt,588,37,102431,31.97,Arbeiderpartiet,625,2015-09-14,426,0.965457464071007,2,733,731
kandidat002029,Torunn Smedal,2007,h,55,52,Ikke valgt,204,1,68475,25.19,Høyre,205,2007-09-10,113,0.636982256715787,0,116,116
kandidat002030,Tove Berstad,2015,sp,26,22,Ikke valgt,21,3,1926,0.6,Senterpartiet,24,2015-09-14,5,0.0356154709266176,0,54,54
kandidat002031,Tove Gilje,2007,h,32,28,Vara,441,7,68475,25.19,Høyre,448,2007-09-10,7,0.193336091130568,1,27,26
kandidat002032,Tove Gjersrud,2007,h,27,29,Vara,530,14,68475,25.19,Høyre,544,2007-09-10,17,3.44033074222623,4,20,16
kandidat002033,Trambi Ugas,2015,sv,36,28,Ikke valgt,164,18,17445,5.44,Sosialistisk Venstreparti,182,2015-09-14,5,0.73006777414568,2,5,3
kandidat002034,Tressy Tresmark,2011,kp,12,4,Ikke valgt,3,0,126000,0.04,Kystpartiet,3,2011-09-12,8,0.125189637356884,1,8,7
kandidat002035,Trine Dønhaug,2007,sv,7,6,Vara,848,82,28701,10.56,Sosialistisk Venstreparti,930,2007-09-10,47,2.36769850586199,3,56,53
kandidat002036,Trine Dønhaug,2011,sv,8,7,Vara,426,70,19477,6.28,Sosialistisk Venstreparti,496,2011-09-12,75,1.87555366659618,2,131,129
kandidat002037,Trine Dønhaug,2015,sv,7,9,Vara,717,97,17445,5.44,Sosialistisk Venstreparti,814,2015-09-14,69,2.68506781479771,4,200,196
kandidat002038,Trine Nicolaysen Dahl,2011,h,16,20,Valgt,1242,19,110776,35.7,Høyre,1261,2011-09-12,1,2.99449737139404e-15,0,4,4
kandidat002039,Trine Østereng,2011,sv,15,19,Ikke valgt,311,36,19477,6.28,Sosialistisk Venstreparti,347,2011-09-12,6,0.26785835352988,1,17,16
kandidat002040,Trine Radmann,2007,v,52,51,Ikke valgt,114,8,23703,8.72,Venstre,122,2007-09-10,22,4.21617164249704e-05,0,93,93
kandidat002041,Trine Skarvang,2007,frp,6,8,Valgt,589,18,38873,14.3,Fremskrittspartiet,607,2007-09-10,56,13.4314357747436,20,57,37
kandidat002042,Trine Skei Grande,2007,v,16,61,Ikke valgt,392,40,23703,8.72,Venstre,432,2007-09-10,5130,293.335276883037,501,6624,6123
kandidat002043,Trine Skei Grande,2011,v,5,33,Valgt,1089,208,25351,8.17,Venstre,1297,2011-09-12,23008,1656.95939150038,3353,29632,26279
kandidat002044,Trond Anders Sorvoja,2015,pirat,20,21,Ikke valgt,18,3,805,0.25,Piratpartiet,21,2015-09-14,3,6.07757768136606e-13,0,4,4
kandidat002045,Trond Enger,2007,v,31,30,Ikke valgt,180,24,23703,8.72,Venstre,204,2007-09-10,220,2.3886183598819,7,285,278
kandidat002046,Trond Hjelmerud,2011,frp,43,52,Ikke valgt,72,6,21852,7.04,Fremskrittspartiet,78,2011-09-12,56,0.209689467583639,0,82,82
kandidat002047,Trond Jensrud,2007,ap,5,3,Valgt,2346,90,81265,29.89,Det norske Arbeiderparti,2436,2007-09-10,909,31.5205353003941,52,1450,1398
kandidat002048,Trond Nordby,2011,rv,37,41,Ikke valgt,65,11,11257,3.63,Rødt,76,2011-09-12,1646,30.5251639771231,61,3635,3574
kandidat002049,Trond Nordby,2015,rv,30,61,Ikke valgt,143,26,16174,5.05,Rødt,169,2015-09-14,1060,13.5202006891106,41,4695,4654
kandidat002050,Trond Selbekk,2007,sfp,15,15,Ikke valgt,5,1,129000,0.05,Samfunnspartiet,6,2007-09-10,9,0.354516525936579,1,20,19
kandidat002051,Trude H. Frølich,2007,osby,9,5,Ikke valgt,35,19,1466,0.54,Oslo Byaksjon,54,NA,0,0,0,0,0
kandidat002052,Trude Iversen,2007,osby,25,17,Ikke valgt,16,9,1466,0.54,Oslo Byaksjon,25,2007-09-10,119,3.31658756566863,7,162,155
kandidat002053,Trude Johnsen,2011,ap,47,39,Ikke valgt,534,11,102707,33.1,Det norske Arbeiderparti,545,2011-09-12,60,1.68263748437638,4,135,131
kandidat002054,Truls Aslaksby,2007,sp,31,42,Ikke valgt,7,8,2189,0.81,Senterpartiet,15,2007-09-10,62,0.850583581966435,2,173,171
kandidat002055,Truls Drageset Dydland,2015,rv,10,8,Ikke valgt,292,39,16174,5.05,Rødt,331,2015-09-14,261,1.21564201224805,2,315,313
kandidat002056,Trygve Karlengen,2015,pp,24,16,Ikke valgt,5,1,1169,0.36,Pensjonistpartiet,6,2015-09-14,2,1.31140097422626e-07,0,8,8
kandidat002057,Turid Aksdal,2007,kp,32,7,Ikke valgt,1,0,120000,0.04,Kystpartiet,1,2007-09-10,3,0.0604462946501319,0,6,6
kandidat002058,Turid Birkeland,2015,ap,20,12,Valgt,2942,116,102431,31.97,Arbeiderpartiet,3058,2015-09-14,1079,20.6710703298257,54,6043,5989
kandidat002059,Turid Eeg Nielsen,2007,pp,19,33,Ikke valgt,10,1,1414,0.52,Pensjonistpartiet,11,NA,0,0,0,0,0
kandidat002060,Turid Vik,2011,mdg,48,62,Ikke valgt,20,12,7653,2.47,Miljøpartiet De Grønne,32,2011-09-12,12,0.243827460893227,2,27,25
kandidat002061,Turi Tingelholm,2007,mdg,49,58,Ikke valgt,7,0,1687,0.62,Miljøpartiet De Grønne,7,2007-09-10,1,1.27827377948843e-06,0,1,1
kandidat002062,Tuva Syvertsen,2015,fi,12,27,Ikke valgt,25,30,1388,0.43,Feministisk Initiativ,55,2015-09-14,1580,17.7333686661929,43,2086,2043
kandidat002063,Ubah Abduqadir,2011,ap,18,49,Valgt,1606,23,102707,33.1,Det norske Arbeiderparti,1629,2011-09-12,80,18.876777094993,73,90,17
kandidat002064,Ulf Ragnar Moen,2007,dem,31,37,Ikke valgt,1,1,306000,0.11,Demokratene,2,NA,0,0,0,0,0
kandidat002065,Ulf Stigen,2007,frp,17,21,Vara,242,25,38873,14.3,Fremskrittspartiet,267,2007-09-10,135,12.7340747953681,19,137,118
kandidat002066,Ulrik Imtiaz Rolfsen,2007,osby,31,61,Ikke valgt,14,7,1466,0.54,Oslo Byaksjon,21,2007-09-10,659,28.6415424505419,54,667,613
kandidat002067,Ulrik Imtiaz Rolfsen,2015,ap,27,41,Vara,1578,126,102431,31.97,Arbeiderpartiet,1704,2015-09-14,2746,221.801857181559,892,4264,3372
kandidat002068,Unn Aarrestad,2007,sp,27,50,Ikke valgt,18,2,2189,0.81,Senterpartiet,20,2007-09-10,67,3.21528928925591,9,397,388
kandidat002069,Unn Aarrestad,2011,sp,19,55,Ikke valgt,14,5,1591,0.51,Senterpartiet,19,2011-09-12,21,1.46769728893844,4,418,414
kandidat002070,Unn Aarrestad,2015,sp,19,30,Ikke valgt,29,2,1926,0.6,Senterpartiet,31,2015-09-14,15,0.151431931472243,1,433,432
kandidat002071,Unni Kjærnes,2015,rv,53,34,Ikke valgt,86,6,16174,5.05,Rødt,92,2015-09-14,155,0.285803402640955,0,344,344
kandidat002072,Unni Rustad,2007,rv,27,59,Ikke valgt,110,15,14131,5.2,Rød Valgallianse,125,2007-09-10,108,0.890953255589106,3,442,439
kandidat002073,Unni Rustad,2011,rv,27,46,Ikke valgt,115,9,11257,3.63,Rødt,124,2011-09-12,80,0.705562044835175,1,522,521
kandidat002074,Vårunn Fossheim Westin,2007,dem,15,25,Ikke valgt,4,1,306000,0.11,Demokratene,5,NA,0,0,0,0,0
kandidat002075,Vårunn Fossheim Westin,2011,dem,7,6,Ikke valgt,4,4,214000,0.07,Demokratene i Norge,8,NA,0,0,0,0,0
kandidat002076,Vedis Vik,2007,sv,10,10,Vara,625,68,28701,10.56,Sosialistisk Venstreparti,693,2007-09-10,17,0.0218140500790595,0,59,59
kandidat002077,Vegard Holm,2011,krf,11,37,Ikke valgt,198,8,7571,2.44,Kristelig Folkeparti,206,2011-09-12,329,20.7578579110011,71,734,663
kandidat002078,Vegard Martinsen,2007,dlf,1,1,Ikke valgt,23,16,127000,0.05,Det Liberale Folkepartiet,39,2007-09-10,51,3.42086641115981,9,117,108
kandidat002079,Vegard Martinsen,2011,dlf,1,1,Ikke valgt,43,33,247000,0.08,Det Liberale Folkepartiet,76,2011-09-12,83,9.46506680594474,12,200,188
kandidat002080,Vegard Ottervig,2015,lib,7,7,Ikke valgt,31,4,458,0.14,Liberalistene Oslo,35,2015-09-14,7022,2.51183920241543,4,7213,7209
kandidat002081,Vegard Setrom,2015,mdg,57,44,Ikke valgt,106,4,26096,8.14,Miljøpartiet De Grønne,110,NA,0,0,0,0,0
kandidat002082,Vera Skistad,2007,sfp,8,6,Ikke valgt,8,1,129000,0.05,Samfunnspartiet,9,NA,0,0,0,0,0
kandidat002083,Vera Vendsbo,2007,h,63,59,Ikke valgt,168,4,68475,25.19,Høyre,172,2007-09-10,1,6.47815678365404e-11,0,9,9
kandidat002084,Veronica Berglyd Olsen,2015,sv,37,37,Ikke valgt,166,16,17445,5.44,Sosialistisk Venstreparti,182,2015-09-14,14,0.287335889823385,2,14,12
kandidat002085,Veronicha Angell Bergli,2007,rv,47,48,Ikke valgt,44,0,14131,5.2,Rød Valgallianse,44,NA,0,0,0,0,0
kandidat002086,Veslemøy Kjendsli,2015,ap,54,42,Ikke valgt,660,12,102431,31.97,Arbeiderpartiet,672,2015-09-14,13,0.148365964060324,0,179,179
kandidat002087,Vibecke Østby,2011,krf,37,24,Ikke valgt,61,2,7571,2.44,Kristelig Folkeparti,63,2011-09-12,2,0.00215534838597036,0,2,2
kandidat002088,Vibecke Østby,2015,krf,38,49,Ikke valgt,47,4,7827,2.44,Kristelig Folkeparti,51,2015-09-14,17,0.633634745451429,1,19,18
kandidat002089,Vibeke Tandberg,2007,osby,18,52,Ikke valgt,23,10,1466,0.54,Oslo Byaksjon,33,2007-09-10,362,10.3173939605773,20,527,507
kandidat002090,Victor Calvert,2007,krf,20,27,Ikke valgt,76,1,8368,3.08,Kristelig Folkeparti,77,2007-09-10,2,0.933326680100179,1,4,3
kandidat002091,Victor Calvert,2015,krf,31,26,Ikke valgt,81,15,7827,2.44,Kristelig Folkeparti,96,2015-09-14,14,2.76811379163416,5,31,26
kandidat002092,Victoria Marie Evensen,2011,ap,20,17,Valgt,1423,34,102707,33.1,Det norske Arbeiderparti,1457,2011-09-12,43,3.42973715664687,7,44,37
kandidat002093,Victoria Marie Evensen,2015,ap,7,8,Valgt,2607,68,102431,31.97,Arbeiderpartiet,2675,2015-09-14,236,11.3036526914842,18,280,262
kandidat002094,Victoria Rweikiza,2011,rv,31,24,Ikke valgt,95,9,11257,3.63,Rødt,104,2011-09-12,31,0.930481905677419,2,33,31
kandidat002095,Victoria Rweikiza,2015,rv,33,22,Ikke valgt,151,10,16174,5.05,Rødt,161,NA,0,0,0,0,0
kandidat002096,Vidar Birkeland,2007,ap,40,47,Ikke valgt,528,38,81265,29.89,Det norske Arbeiderparti,566,2007-09-10,71,3.47234554086941,9,140,131
kandidat002097,Vidar Bysheim,2007,dem,19,29,Ikke valgt,4,0,306000,0.11,Demokratene,4,2007-09-10,1,9.00631019981828e-05,0,1,1
kandidat002098,Vidar Hillesland,2011,mdg,65,47,Ikke valgt,12,1,7653,2.47,Miljøpartiet De Grønne,13,NA,0,0,0,0,0
kandidat002099,Vidar Karlsen,2011,frp,35,34,Ikke valgt,100,7,21852,7.04,Fremskrittspartiet,107,2011-09-12,675,13.1700731428418,36,1429,1393
kandidat002100,Vidar Vaage,2007,kp,12,6,Ikke valgt,3,1,120000,0.04,Kystpartiet,4,NA,0,0,0,0,0
kandidat002101,Vigdis Ø Wilhelmsen,2015,ksp,8,7,Ikke valgt,18,2,421,0.13,Partiet De Kristne,20,2015-09-14,3,1.90252434832368,3,3,0
kandidat002102,Vigdis Ystad,2007,v,49,60,Ikke valgt,117,14,23703,8.72,Venstre,131,2007-09-10,385,3.32530346269206,8,650,642
kandidat002103,Viktor Bäcklin,2007,pp,10,12,Ikke valgt,16,1,1414,0.52,Pensjonistpartiet,17,2007-09-10,21,0.311416077625872,1,67,66
kandidat002104,Wenche Hansgaard,2011,ap,52,53,Ikke valgt,433,5,102707,33.1,Det norske Arbeiderparti,438,2011-09-12,33,1.47991060833349,2,65,63
kandidat002105,Wenche O. Jønland,2011,kp,10,12,Ikke valgt,4,0,126000,0.04,Kystpartiet,4,NA,0,0,0,0,0
kandidat002106,William Fagerheim,2011,kp,4,7,Ikke valgt,9,1,126000,0.04,Kystpartiet,10,2011-09-12,4,1.03958700718971e-06,0,21,21
kandidat002107,Willy Nyhagen,2011,dem,12,18,Ikke valgt,5,2,214000,0.07,Demokratene i Norge,7,2011-09-12,2,0.0577287478446645,0,9,9
kandidat002108,Willy Wiesner,2007,dem,29,33,Ikke valgt,2,0,306000,0.11,Demokratene,2,NA,0,0,0,0,0
kandidat002109,Ximena Azzari Støen,2015,fi,7,8,Ikke valgt,62,35,1388,0.43,Feministisk Initiativ,97,2015-09-14,11,4.71974295615821,7,11,4
kandidat002110,Yan Friis,2007,kp,3,16,Ikke valgt,3,8,120000,0.04,Kystpartiet,11,2007-09-10,85,4.53530826201977,8,232,224
kandidat002111,Yan Friis,2015,kp,3,5,Ikke valgt,6,11,124,0.04,Kystpartiet,17,2015-09-14,375,10.5186673004624,24,758,734
kandidat002112,Yasmin Mujahid,2007,ap,16,30,Valgt,1212,145,81265,29.89,Det norske Arbeiderparti,1357,2007-09-10,4,1.38176116884038,2,42,40
kandidat002113,Yassine Arakia,2011,h,25,11,Vara,722,59,110776,35.7,Høyre,781,2011-09-12,18,2.8383839765758,3,19,16
kandidat002114,Yassine Arakia,2015,h,10,9,Valgt,1046,50,101882,31.8,Høyre,1096,2015-09-14,99,5.38527354619315,8,118,110
kandidat002115,Yngve Slettholm,2015,krf,21,14,Ikke valgt,115,16,7827,2.44,Kristelig Folkeparti,131,2015-09-14,829,8.97269919891906,24,3093,3069
kandidat002116,Yvonne Berit Kristoffersen,2007,kp,22,25,Ikke valgt,2,0,120000,0.04,Kystpartiet,2,NA,0,0,0,0,0
kandidat002117,Yvonne Kristoffersen,2011,kp,17,15,Ikke valgt,1,1,126000,0.04,Kystpartiet,2,2011-09-12,7,0.00720039527472861,0,13,13
kandidat002118,Yvonne Kristoffersen,2015,kp,6,10,Ikke valgt,8,1,124,0.04,Kystpartiet,9,2015-09-14,14,0.00195097524102913,0,27,27
kandidat002119,Zahir Athari,2011,rv,17,23,Ikke valgt,177,25,11257,3.63,Rødt,202,2011-09-12,274,2.49987658309505,5,1516,1511
kandidat002120,Zaineb Al-Samarai,2011,ap,16,31,Valgt,1925,90,102707,33.1,Det norske Arbeiderparti,2015,2011-09-12,10,1.16163330157303,2,29,27
kandidat002121,Zaineb Al-Samarai,2015,ap,33,38,Vara,1344,75,102431,31.97,Arbeiderpartiet,1419,2015-09-14,91,2.1351773953196,2,120,118
